,ZIP Code,Voluntary Market Units,FAIR Plan Units,Total Ins Units,Pct Market,Pct FAIR
0,90001,6913,2104,9017,0.7666629699456582,0.2333370300543418
1,90002,6534,1330,7864,0.8308748728382502,0.16912512716174974
2,90003,8716,1934,10650,0.8184037558685446,0.1815962441314554
3,90004,4710,495,5205,0.9048991354466859,0.09510086455331412
4,90005,996,100,1096,0.9087591240875912,0.09124087591240876
5,90006,2402,836,3238,0.7418159357628166,0.25818406423718343
6,90007,2369,728,3097,0.7649338069099129,0.2350661930900872
7,90008,4774,244,5018,0.9513750498206457,0.04862495017935432
8,90010,69,1,70,0.9857142857142858,0.014285714285714285
9,90011,10249,3336,13585,0.7544350386455649,0.24556496135443504
10,90012,827,87,914,0.9048140043763676,0.09518599562363239
11,90013,98,0,98,1.0,0.0
12,90014,56,0,56,1.0,0.0
13,90015,433,108,541,0.800369685767098,0.19963031423290203
14,90016,7218,757,7975,0.9050783699059561,0.09492163009404389
15,90017,192,21,213,0.9014084507042254,0.09859154929577464
16,90018,6469,1236,7705,0.8395846852693056,0.16041531473069434
17,90019,8223,979,9202,0.8936100847641817,0.1063899152358183
18,90020,769,35,804,0.9564676616915423,0.043532338308457715
19,90021,67,9,76,0.881578947368421,0.11842105263157894
20,90022,9614,1315,10929,0.879677921127276,0.12032207887272395
21,90023,4988,1313,6301,0.7916203777178226,0.20837962228217743
22,90024,3027,22,3049,0.9927845195145949,0.007215480485405051
23,90025,2833,53,2886,0.9816354816354816,0.018364518364518363
24,90026,9124,1114,10238,0.8911896854854464,0.10881031451455363
25,90027,5380,291,5671,0.9486862987127491,0.05131370128725093
26,90028,748,59,807,0.9268897149938042,0.07311028500619579
27,90029,2423,367,2790,0.8684587813620072,0.13154121863799284
28,90031,5094,875,5969,0.8534092812866477,0.14659071871335233
29,90032,7497,662,8159,0.9188626057114843,0.08113739428851575
30,90033,4107,997,5104,0.8046630094043887,0.1953369905956113
31,90034,5072,109,5181,0.9789615904265586,0.02103840957344142
32,90035,4215,89,4304,0.97932156133829,0.020678438661710038
33,90036,3739,92,3831,0.9759853824066823,0.02401461759331767
34,90037,6424,2002,8426,0.762402088772846,0.23759791122715404
35,90038,1628,162,1790,0.9094972067039107,0.09050279329608939
36,90039,7249,375,7624,0.950813221406086,0.04918677859391395
37,90040,2070,178,2248,0.9208185053380783,0.0791814946619217
38,90041,5955,252,6207,0.9594006766553891,0.04059932334461092
39,90042,9881,897,10778,0.9167749118574875,0.08322508814251253
40,90043,9830,690,10520,0.9344106463878327,0.0655893536121673
41,90044,12618,2127,14745,0.8557477110885046,0.1442522889114954
42,90045,8968,28,8996,0.9968875055580257,0.0031124944419742106
43,90046,4814,1850,6664,0.7223889555822329,0.2776110444177671
44,90047,11524,941,12465,0.9245086241476134,0.07549137585238669
45,90048,3631,102,3733,0.9726761317974819,0.027323868202518083
46,90049,6654,887,7541,0.8823763426601247,0.11762365733987534
47,90056,2275,16,2291,0.9930161501527717,0.006983849847228284
48,90057,525,127,652,0.8052147239263804,0.19478527607361965
49,90058,147,58,205,0.7170731707317073,0.28292682926829266
50,90059,5742,798,6540,0.8779816513761468,0.12201834862385322
51,90061,3951,581,4532,0.8718005295675199,0.12819947043248014
52,90062,5401,1045,6446,0.8378839590443686,0.1621160409556314
53,90063,7355,1659,9014,0.8159529620590193,0.1840470379409807
54,90064,6257,47,6304,0.9925444162436549,0.0074555837563451775
55,90065,9252,835,10087,0.9172201843957569,0.08277981560424308
56,90066,10267,53,10320,0.9948643410852713,0.005135658914728682
57,90067,133,0,133,1.0,0.0
58,90068,4931,1116,6047,0.8154456755415909,0.18455432445840914
59,90069,2548,242,2790,0.9132616487455197,0.08673835125448029
61,90077,1680,1433,3113,0.5396723417924831,0.46032765820751687
62,90094,499,0,499,1.0,0.0
63,90201,11460,1116,12576,0.9112595419847328,0.08874045801526717
64,90210,4464,1803,6267,0.7123025370990905,0.28769746290090953
65,90211,1269,35,1304,0.973159509202454,0.026840490797546013
66,90212,1316,28,1344,0.9791666666666666,0.020833333333333332
67,90220,8811,701,9512,0.9263036164844407,0.0736963835155593
68,90221,7454,871,8325,0.8953753753753754,0.10462462462462463
69,90222,4816,611,5427,0.8874147779620416,0.11258522203795836
70,90230,5189,44,5233,0.9915918211351041,0.008408178864895853
71,90232,3336,42,3378,0.9875666074600356,0.012433392539964476
72,90240,5457,109,5566,0.9804168163851958,0.019583183614804166
73,90241,7201,124,7325,0.9830716723549489,0.016928327645051193
74,90242,7163,159,7322,0.9782846216880634,0.02171537831193663
75,90245,3359,4,3363,0.9988105857865002,0.0011894142134998512
76,90247,7575,224,7799,0.9712783690216694,0.028721630978330557
77,90248,2326,46,2372,0.9806070826306914,0.0193929173693086
78,90249,5396,77,5473,0.9859309336744017,0.014069066325598392
79,90250,12867,378,13245,0.9714609286523216,0.028539071347678368
80,90254,5181,16,5197,0.996921300750433,0.003078699249567058
81,90255,8518,1150,9668,0.8810508895324782,0.11894911046752173
82,90260,6475,148,6623,0.9776536312849162,0.0223463687150838
83,90262,8712,853,9565,0.9108207004704653,0.08917929952953477
84,90265,3757,1693,5450,0.6893577981651376,0.3106422018348624
85,90266,10842,34,10876,0.9968738506803972,0.003126149319602795
86,90270,3381,419,3800,0.8897368421052632,0.11026315789473684
87,90272,6613,578,7191,0.9196217494089834,0.08037825059101655
88,90274,8263,45,8308,0.9945835339431873,0.005416466056812711
89,90275,12158,61,12219,0.9950077747769867,0.00499222522301334
90,90277,6847,34,6881,0.995058857724168,0.004941142275832001
91,90278,8408,31,8439,0.9963265789785519,0.0036734210214480387
92,90280,14367,1201,15568,0.9228545734840699,0.07714542651593011
93,90290,561,1792,2353,0.2384190395240119,0.7615809604759881
94,90291,6821,149,6970,0.978622668579627,0.021377331420373027
95,90292,1415,12,1427,0.9915907498248073,0.008409250175192713
96,90293,1636,7,1643,0.995739500912964,0.00426049908703591
97,90301,4038,303,4341,0.9302004146510021,0.06979958534899793
98,90302,3370,247,3617,0.9317113630080177,0.0682886369919823
99,90303,4301,253,4554,0.9444444444444444,0.05555555555555555
100,90304,3408,331,3739,0.9114736560577694,0.08852634394223054
101,90305,3522,106,3628,0.9707828004410143,0.029217199558985666
102,90401,187,2,189,0.9894179894179894,0.010582010582010581
103,90402,3368,26,3394,0.9923394225103123,0.0076605774896876845
104,90403,1710,30,1740,0.9827586206896551,0.017241379310344827
105,90404,1527,49,1576,0.9689086294416244,0.031091370558375634
106,90405,4519,81,4600,0.9823913043478261,0.017608695652173913
107,90501,7456,115,7571,0.9848104609694889,0.015189539030511161
108,90502,3101,42,3143,0.9866369710467706,0.013363028953229399
109,90503,8079,18,8097,0.9977769544275658,0.002223045572434235
110,90504,7610,18,7628,0.9976402726796014,0.0023597273203985318
111,90505,8317,20,8337,0.9976010555355643,0.0023989444644356484
112,90601,6934,264,7198,0.9633231453181439,0.03667685468185607
113,90602,4221,149,4370,0.9659038901601831,0.03409610983981693
114,90603,5656,40,5696,0.9929775280898876,0.007022471910112359
115,90604,8428,96,8524,0.9887376818395119,0.011262318160488035
116,90605,8419,235,8654,0.9728449272012942,0.0271550727987058
117,90606,6653,208,6861,0.969683719574406,0.030316280425593936
118,90620,10826,20,10846,0.9981560022127973,0.0018439977872026553
119,90621,3863,19,3882,0.9951056156620299,0.004894384337970119
120,90623,3701,7,3708,0.9981121898597627,0.0018878101402373248
121,90630,10692,22,10714,0.997946611909651,0.002053388090349076
122,90631,12999,274,13273,0.9793565885632487,0.0206434114367513
123,90638,11870,64,11934,0.9946371711077593,0.005362828892240657
124,90640,9964,335,10299,0.967472570152442,0.03252742984755801
125,90650,18990,394,19384,0.9796739579034255,0.020326042096574494
126,90660,12090,421,12511,0.9663496123411398,0.033650387658860206
127,90670,3091,42,3133,0.9865943185445261,0.013405681455473986
128,90680,3591,9,3600,0.9975,0.0025
129,90701,3291,73,3364,0.9782996432818074,0.021700356718192627
130,90703,12978,48,13026,0.9963150621833257,0.0036849378166743437
131,90704,319,234,553,0.5768535262206148,0.4231464737793852
132,90706,11561,239,11800,0.9797457627118644,0.020254237288135593
133,90710,4550,72,4622,0.9844223279965383,0.015577672003461706
134,90712,9203,36,9239,0.9961034744019915,0.0038965255980084423
135,90713,9087,28,9115,0.9969281404278661,0.003071859572133845
136,90715,3507,73,3580,0.979608938547486,0.020391061452513966
137,90716,1791,91,1882,0.9516471838469713,0.048352816153028694
138,90717,4433,72,4505,0.9840177580466148,0.01598224195338513
139,90720,5821,4,5825,0.9993133047210301,0.0006866952789699571
140,90723,6515,304,6819,0.9554186830913624,0.04458131690863763
141,90731,10801,272,11073,0.9754357446039917,0.02456425539600831
142,90732,4622,15,4637,0.9967651498813889,0.003234850118611171
143,90740,4741,6,4747,0.9987360438171476,0.0012639561828523278
144,90742,303,4,307,0.9869706840390879,0.013029315960912053
145,90743,139,2,141,0.9858156028368794,0.014184397163120567
146,90744,7110,412,7522,0.9452273331560755,0.05477266684392449
147,90745,10390,175,10565,0.9834358731661146,0.01656412683388547
148,90746,6957,144,7101,0.9797211660329531,0.020278833967046894
149,90755,1750,27,1777,0.9848058525604952,0.015194147439504783
150,90802,2178,91,2269,0.9598942265315117,0.04010577346848832
151,90803,7672,34,7706,0.9955878536205555,0.004412146379444588
152,90804,4669,168,4837,0.9652677279305355,0.03473227206946455
153,90805,14700,531,15231,0.9651368918652747,0.034863108134725235
154,90806,6220,310,6530,0.9525267993874426,0.04747320061255743
155,90807,7113,68,7181,0.9905305667734299,0.009469433226570116
156,90808,12915,20,12935,0.9984538074990337,0.0015461925009663702
157,90810,6372,208,6580,0.9683890577507599,0.031610942249240125
158,90813,4295,399,4694,0.9149978696207925,0.0850021303792075
159,90814,3728,48,3776,0.9872881355932204,0.012711864406779662
160,90815,10746,19,10765,0.9982350209010683,0.0017649790989317231
161,91001,10591,668,11259,0.9406696864730438,0.05933031352695621
162,91006,8204,133,8337,0.984047019311503,0.01595298068849706
163,91007,5662,76,5738,0.9867549668874173,0.013245033112582781
164,91008,278,89,367,0.7574931880108992,0.24250681198910082
165,91010,5157,159,5316,0.9700902934537246,0.029909706546275394
166,91011,6113,377,6490,0.9419106317411402,0.05808936825885978
167,91016,9091,299,9390,0.968157614483493,0.03184238551650692
168,91020,1144,39,1183,0.967032967032967,0.03296703296703297
170,91024,3151,324,3475,0.9067625899280576,0.09323741007194244
171,91030,5019,150,5169,0.9709808473592572,0.02901915264074289
172,91040,5510,428,5938,0.9279218592118559,0.07207814078814416
173,91042,5967,698,6665,0.8952738184546136,0.10472618154538635
174,91101,829,62,891,0.9304152637485971,0.06958473625140292
175,91103,4712,300,5012,0.9401436552274541,0.05985634477254589
176,91104,8704,253,8957,0.9717539354694652,0.028246064530534777
177,91105,2921,157,3078,0.9489928525016245,0.051007147498375566
178,91106,3449,84,3533,0.9762241720917068,0.023775827908293235
179,91107,8914,263,9177,0.9713413969706876,0.02865860302931241
180,91108,4311,49,4360,0.9887614678899083,0.011238532110091744
181,91201,3620,104,3724,0.9720730397422127,0.027926960257787327
182,91202,3413,130,3543,0.9633079311318092,0.0366920688681908
183,91203,1039,33,1072,0.9692164179104478,0.030783582089552237
184,91204,1003,65,1068,0.9391385767790262,0.060861423220973786
185,91205,3068,119,3187,0.9626608095387512,0.037339190461248825
186,91206,3899,610,4509,0.8647150144156133,0.13528498558438679
187,91207,2445,121,2566,0.9528448947778644,0.04715510522213562
188,91208,4064,387,4451,0.9130532464614693,0.08694675353853067
190,91214,8411,257,8668,0.9703507152745732,0.02964928472542686
191,91301,6504,579,7083,0.9182549767047861,0.0817450232952139
192,91302,6100,831,6931,0.8801038811138364,0.11989611888616361
193,91303,2344,75,2419,0.9689954526663911,0.03100454733360893
194,91304,8613,326,8939,0.9635305962635642,0.03646940373643584
195,91306,8579,156,8735,0.9821408128219805,0.017859187178019462
196,91307,7712,239,7951,0.9699408879386241,0.030059112061375928
197,91311,8135,283,8418,0.9663815633167023,0.0336184366832977
198,91316,5270,145,5415,0.9732225300092336,0.02677746999076639
199,91320,12184,124,12308,0.9899252518687033,0.010074748131296718
200,91321,4851,213,5064,0.9579383886255924,0.04206161137440758
201,91324,5039,58,5097,0.9886207573082205,0.011379242691779479
202,91325,5827,94,5921,0.9841243033271407,0.015875696672859315
203,91326,10554,150,10704,0.9859865470852018,0.014013452914798207
204,91331,13527,858,14385,0.940354535974974,0.05964546402502607
205,91335,11974,336,12310,0.9727051177904142,0.027294882209585702
206,91340,5483,331,5814,0.9430684554523564,0.05693154454764362
207,91342,16006,952,16958,0.9438613043991037,0.056138695600896335
208,91343,8904,185,9089,0.9796457256023765,0.020354274397623502
209,91344,13608,287,13895,0.979345088161209,0.02065491183879093
210,91345,4070,98,4168,0.9764875239923224,0.023512476007677544
211,91350,10971,189,11160,0.9830645161290322,0.016935483870967744
212,91351,7427,144,7571,0.9809800554748382,0.0190199445251618
213,91352,7105,546,7651,0.9286367795059469,0.07136322049405307
214,91354,8372,49,8421,0.9941812136325852,0.005818786367414797
215,91355,7152,7,7159,0.9990222098058388,0.0009777901941611957
216,91356,5582,229,5811,0.9605919807262089,0.03940801927379108
217,91360,10590,72,10662,0.9932470455824424,0.006752954417557681
218,91361,5384,417,5801,0.9281158420961904,0.07188415790380968
219,91362,8815,152,8967,0.9830489572878331,0.016951042712166835
220,91364,7923,351,8274,0.957577955039884,0.04242204496011603
221,91367,8353,115,8468,0.9864194615021257,0.01358053849787435
222,91377,3392,70,3462,0.9797804737146159,0.020219526285384173
223,91381,4342,121,4463,0.9728881917992381,0.027111808200761818
224,91384,5073,854,5927,0.8559136156571622,0.14408638434283785
225,91387,7409,481,7890,0.9390367553865653,0.060963244613434726
226,91390,4571,750,5321,0.8590490509302763,0.14095094906972375
227,91401,5845,124,5969,0.9792260010051935,0.0207739989948065
228,91402,5701,241,5942,0.9594412655671491,0.04055873443285089
229,91403,4147,341,4488,0.9240196078431373,0.07598039215686274
230,91405,4822,160,4982,0.9678843837816138,0.03211561621838619
231,91406,8265,180,8445,0.9786856127886323,0.021314387211367674
232,91411,2578,59,2637,0.9776260902540767,0.022373909745923397
233,91423,5051,453,5504,0.9176962209302325,0.08230377906976744
234,91436,4632,214,4846,0.9558398679323153,0.04416013206768469
235,91501,2761,144,2905,0.9504302925989673,0.049569707401032705
236,91502,508,13,521,0.9750479846449136,0.02495201535508637
237,91504,4982,138,5120,0.973046875,0.026953125
238,91505,7801,93,7894,0.9882189004307068,0.011781099569293133
239,91506,5099,48,5147,0.9906741791334758,0.00932582086652419
240,91601,3869,177,4046,0.9562530894710826,0.04374691052891745
241,91602,2537,30,2567,0.9883132060771328,0.01168679392286716
242,91604,5568,527,6095,0.9135356849876949,0.08646431501230517
243,91605,7114,298,7412,0.95979492714517,0.04020507285483001
244,91606,5771,264,6035,0.9562551781275891,0.04374482187241094
245,91607,4099,34,4133,0.9917735301233971,0.008226469876602952
246,91701,11164,56,11220,0.9950089126559715,0.004991087344028521
247,91702,9554,286,9840,0.9709349593495935,0.029065040650406503
248,91706,11803,494,12297,0.9598276002276979,0.040172399772302185
249,91708,2801,7,2808,0.9975071225071225,0.002492877492877493
250,91709,19148,685,19833,0.9654616043967126,0.03453839560328745
251,91710,17507,74,17581,0.9957909106421705,0.004209089357829475
252,91711,8317,103,8420,0.9877672209026128,0.012232779097387174
253,91722,7470,110,7580,0.9854881266490765,0.014511873350923483
254,91723,3267,34,3301,0.9897000908815511,0.010299909118448955
255,91724,5766,109,5875,0.9814468085106383,0.0185531914893617
256,91730,11019,35,11054,0.9968337253482902,0.0031662746517097883
257,91731,3907,182,4089,0.9554903399364147,0.04450966006358523
258,91732,8634,318,8952,0.9644772117962467,0.035522788203753354
259,91733,5688,298,5986,0.9502171734046108,0.04978282659538924
260,91737,6278,98,6376,0.9846298619824341,0.015370138017565873
261,91739,9062,82,9144,0.9910323709536308,0.008967629046369203
262,91740,5808,66,5874,0.9887640449438202,0.011235955056179775
263,91741,7463,212,7675,0.9723778501628665,0.027622149837133552
264,91744,13622,615,14237,0.9568026971974433,0.043197302802556715
265,91745,12692,354,13046,0.9728652460524299,0.027134753947570138
266,91746,5292,221,5513,0.9599129330672955,0.040087066932704515
267,91748,9442,182,9624,0.9810889443059019,0.018911055694098088
268,91750,9359,150,9509,0.9842254706067936,0.015774529393206435
269,91752,7497,75,7572,0.9900950871632329,0.009904912836767036
270,91754,7106,111,7217,0.9846196480532077,0.015380351946792296
271,91755,4779,63,4842,0.9869888475836431,0.013011152416356878
272,91759,130,112,242,0.5371900826446281,0.4628099173553719
273,91761,13202,80,13282,0.993976810721277,0.006023189278723084
274,91762,11698,85,11783,0.9927862174318934,0.007213782568106594
275,91763,6345,48,6393,0.992491787893008,0.007508212106992022
276,91764,8481,88,8569,0.9897304236200257,0.010269576379974325
277,91765,10614,455,11069,0.9588942090523083,0.041105790947691755
278,91766,11606,437,12043,0.9637133604583575,0.03628663954164245
279,91767,8578,224,8802,0.9745512383549193,0.025448761645080663
280,91768,5273,196,5469,0.9641616383251052,0.03583836167489486
281,91770,12130,323,12453,0.9740624749056452,0.025937525094354773
282,91773,8053,180,8233,0.9781367666707154,0.021863233329284585
283,91775,6282,46,6328,0.9927307206068268,0.007269279393173199
284,91776,5932,144,6076,0.9763001974983542,0.02369980250164582
285,91780,8789,94,8883,0.9894179894179894,0.010582010582010581
286,91784,8642,78,8720,0.9910550458715597,0.008944954128440367
287,91786,9492,53,9545,0.994447354635935,0.005552645364064955
288,91789,11210,169,11379,0.9851480797961156,0.014851920203884348
289,91790,9368,152,9520,0.9840336134453781,0.015966386554621848
290,91791,6905,108,7013,0.9846000285184657,0.015399971481534293
291,91792,5161,65,5226,0.9875621890547264,0.012437810945273632
292,91801,7654,194,7848,0.9752803261977574,0.02471967380224261
293,91803,6269,148,6417,0.97693626305127,0.023063736948729936
294,91901,3341,1558,4899,0.6819759134517248,0.31802408654827513
295,91902,4867,22,4889,0.995500102270403,0.004499897729597055
296,91905,395,109,504,0.7837301587301587,0.21626984126984128
297,91906,733,214,947,0.7740232312565998,0.22597676874340022
298,91910,13616,16,13632,0.9988262910798122,0.0011737089201877935
299,91911,13568,18,13586,0.9986751067275136,0.001324893272486383
300,91913,10745,10,10755,0.99907019990702,0.0009298000929800093
301,91914,4022,28,4050,0.9930864197530864,0.006913580246913581
302,91915,5938,8,5946,0.9986545576858392,0.0013454423141607804
303,91916,349,275,624,0.5592948717948718,0.4407051282051282
304,91917,113,60,173,0.653179190751445,0.3468208092485549
305,91931,45,53,98,0.45918367346938777,0.5408163265306123
306,91932,4732,11,4743,0.9976807927472064,0.0023192072527935905
307,91934,191,17,208,0.9182692307692307,0.08173076923076923
308,91935,1789,894,2683,0.6667909057025717,0.33320909429742823
309,91941,9268,20,9288,0.9978466838931955,0.002153316106804479
310,91942,7211,3,7214,0.9995841419462157,0.0004158580537843083
311,91945,6324,14,6338,0.9977911012937836,0.002208898706216472
312,91948,66,81,147,0.4489795918367347,0.5510204081632653
313,91950,7767,26,7793,0.9966636725266265,0.0033363274733735405
314,91962,528,228,756,0.6984126984126984,0.30158730158730157
315,91963,110,53,163,0.6748466257668712,0.32515337423312884
316,91977,12583,59,12642,0.9953330169277013,0.0046669830722986866
317,91978,2146,81,2227,0.9636281993713516,0.03637180062864841
319,92003,1358,67,1425,0.9529824561403509,0.047017543859649125
320,92004,1963,21,1984,0.9894153225806451,0.010584677419354838
321,92007,3275,2,3277,0.9993896856881294,0.0006103143118706134
322,92008,6526,19,6545,0.9970970206264324,0.0029029793735676087
323,92009,11498,47,11545,0.9959289735816371,0.004071026418362928
324,92010,4523,9,4532,0.9980141218005296,0.0019858781994704323
325,92011,6428,10,6438,0.9984467225846536,0.0015532774153463808
326,92014,4336,27,4363,0.993811597524639,0.00618840247536099
327,92019,9747,266,10013,0.9734345351043643,0.026565464895635674
328,92020,9602,12,9614,0.9987518202621177,0.001248179737882255
329,92021,12064,323,12387,0.9739242754500687,0.02607572454993138
330,92024,14238,79,14317,0.9944820842355242,0.005517915764475798
331,92025,7840,119,7959,0.9850483729111698,0.014951627088830254
332,92026,11748,712,12460,0.9428571428571428,0.05714285714285714
333,92027,11352,217,11569,0.9812429769210822,0.018757023078917797
334,92028,13479,878,14357,0.9388451626384342,0.06115483736156579
335,92029,6142,336,6478,0.9481321395492436,0.051867860450756406
336,92036,1036,724,1760,0.5886363636363636,0.4113636363636364
337,92037,9869,63,9932,0.9936568666935159,0.0063431333064840915
338,92040,10143,297,10440,0.971551724137931,0.028448275862068967
339,92054,8263,11,8274,0.9986705342035291,0.0013294657964708727
340,92056,15202,18,15220,0.9988173455978975,0.0011826544021024967
341,92057,14251,36,14287,0.9974802267795898,0.002519773220410163
342,92058,4133,13,4146,0.9968644476603956,0.003135552339604438
343,92059,86,71,157,0.5477707006369427,0.45222929936305734
344,92060,80,89,169,0.47337278106508873,0.5266272189349113
345,92061,539,85,624,0.8637820512820513,0.1362179487179487
346,92064,12660,247,12907,0.9808630975439684,0.01913690245603161
347,92065,8584,1472,10056,0.8536197295147175,0.14638027048528243
348,92066,154,22,176,0.875,0.125
349,92067,2658,218,2876,0.9242002781641169,0.07579972183588317
350,92069,9691,153,9844,0.984457537586347,0.015542462413652987
351,92070,177,101,278,0.6366906474820144,0.36330935251798563
352,92071,13528,62,13590,0.9954378219278881,0.004562178072111847
353,92075,3076,4,3080,0.9987012987012988,0.0012987012987012987
354,92078,11716,201,11917,0.9831333389275825,0.016866661072417556
355,92081,6451,14,6465,0.9978344934261407,0.002165506573859242
356,92082,5034,836,5870,0.8575809199318569,0.1424190800681431
357,92083,6435,14,6449,0.9978291207939215,0.0021708792060784617
358,92084,10050,348,10398,0.966532025389498,0.03346797461050202
359,92086,292,292,584,0.5,0.5
360,92091,815,13,828,0.9842995169082126,0.01570048309178744
361,92101,1931,29,1960,0.985204081632653,0.01479591836734694
362,92102,6736,232,6968,0.9667049368541906,0.03329506314580941
363,92103,5903,63,5966,0.9894401609118337,0.010559839088166276
364,92104,8530,72,8602,0.9916298535224366,0.008370146477563357
365,92105,9716,216,9932,0.9782521143777688,0.02174788562223117
366,92106,5328,12,5340,0.9977528089887641,0.0022471910112359553
367,92107,7016,41,7057,0.9941901657928298,0.005809834207170185
368,92108,1253,2,1255,0.998406374501992,0.0015936254980079682
369,92109,9132,36,9168,0.9960732984293194,0.003926701570680628
370,92110,4151,24,4175,0.994251497005988,0.005748502994011976
371,92111,8561,23,8584,0.9973205964585274,0.002679403541472507
372,92113,6574,279,6853,0.9592879031081278,0.04071209689187217
373,92114,14783,100,14883,0.9932809245447827,0.006719075455217362
374,92115,10265,47,10312,0.9954422032583398,0.004557796741660201
375,92116,7035,91,7126,0.9872298624754421,0.012770137524557957
376,92117,13846,29,13875,0.9979099099099099,0.00209009009009009
377,92118,4796,3,4799,0.9993748697645343,0.000625130235465722
378,92119,6495,30,6525,0.9954022988505747,0.004597701149425287
379,92120,8428,63,8491,0.9925803792250618,0.00741962077493817
380,92121,788,11,799,0.986232790988736,0.01376720901126408
381,92122,5464,8,5472,0.9985380116959064,0.0014619883040935672
382,92123,5055,9,5064,0.9982227488151659,0.0017772511848341231
383,92124,4618,33,4651,0.9929047516663083,0.0070952483336916795
384,92126,14634,57,14691,0.9961200735143966,0.003879926485603431
385,92127,11405,85,11490,0.9926022628372497,0.0073977371627502175
386,92128,11242,51,11293,0.9954839280970512,0.00451607190294873
387,92129,12861,210,13071,0.9839338994721138,0.01606610052788616
388,92130,13126,91,13217,0.9931149277445714,0.006885072255428615
389,92131,8723,352,9075,0.9612121212121212,0.03878787878787879
390,92139,6301,20,6321,0.9968359436797976,0.0031640563202024997
391,92154,12995,31,13026,0.9976201443267312,0.002379855673268847
392,92173,2435,20,2455,0.9918533604887984,0.008146639511201629
393,92201,14862,24,14886,0.9983877468762595,0.0016122531237404273
394,92203,11928,9,11937,0.9992460417190249,0.0007539582809751194
395,92210,3295,4,3299,0.9987875113670809,0.0012124886329190664
396,92211,10949,2,10951,0.9998173682768697,0.00018263172313030774
397,92220,9549,233,9782,0.9761807401349417,0.02381925986505827
398,92223,17741,360,18101,0.9801115960444174,0.019888403955582563
399,92225,4384,23,4407,0.9947810301792602,0.005218969820739733
400,92227,5277,23,5300,0.9956603773584906,0.004339622641509434
401,92230,542,29,571,0.9492119089316988,0.050788091068301226
402,92231,6545,105,6650,0.9842105263157894,0.015789473684210527
403,92233,635,4,639,0.9937402190923318,0.006259780907668232
404,92234,14314,21,14335,0.998535054063481,0.0014649459365190093
405,92236,6967,15,6982,0.9978516184474363,0.002148381552563735
406,92239,149,0,149,1.0,0.0
407,92240,10438,52,10490,0.9950428979980934,0.004957102001906578
408,92241,3522,20,3542,0.9943534726143421,0.00564652738565782
409,92242,1162,6,1168,0.9948630136986302,0.005136986301369863
410,92243,8723,84,8807,0.9904621323946861,0.009537867605313955
411,92249,1286,4,1290,0.9968992248062015,0.0031007751937984496
412,92250,1493,11,1504,0.992686170212766,0.007313829787234043
413,92251,6046,15,6061,0.9975251608645438,0.0024748391354561953
414,92252,3789,45,3834,0.9882629107981221,0.011737089201877934
415,92253,17410,10,17420,0.9994259471871412,0.000574052812858783
416,92254,1336,7,1343,0.9947877885331348,0.0052122114668652275
417,92256,1477,40,1517,0.97363216875412,0.026367831245880026
418,92257,522,3,525,0.9942857142857143,0.005714285714285714
419,92258,114,2,116,0.9827586206896551,0.017241379310344827
420,92259,143,2,145,0.9862068965517241,0.013793103448275862
421,92260,10517,15,10532,0.9985757690846943,0.001424230915305735
422,92262,8823,14,8837,0.9984157519520199,0.0015842480479800838
423,92264,6372,11,6383,0.998276672411092,0.001723327588908037
424,92266,153,0,153,1.0,0.0
425,92267,457,1,458,0.9978165938864629,0.002183406113537118
426,92268,282,30,312,0.9038461538461539,0.09615384615384616
427,92270,8135,10,8145,0.9987722529158993,0.0012277470841006752
428,92273,201,9,210,0.9571428571428572,0.04285714285714286
429,92274,2735,17,2752,0.9938226744186046,0.0061773255813953485
430,92275,163,1,164,0.9939024390243902,0.006097560975609756
431,92276,3072,22,3094,0.9928894634776988,0.007110536522301228
432,92277,5930,49,5979,0.9918046496069577,0.008195350393042315
434,92281,389,3,392,0.9923469387755102,0.007653061224489796
435,92282,394,47,441,0.8934240362811792,0.10657596371882086
436,92283,206,2,208,0.9903846153846154,0.009615384615384616
437,92284,9448,72,9520,0.992436974789916,0.007563025210084034
438,92285,991,52,1043,0.950143815915628,0.04985618408437201
439,92301,7853,103,7956,0.9870537958773253,0.012946204122674712
440,92305,190,234,424,0.4481132075471698,0.5518867924528302
441,92307,11541,56,11597,0.9951711649564543,0.004828835043545744
442,92308,13269,74,13343,0.9944540208348946,0.005545979165105299
443,92309,34,1,35,0.9714285714285714,0.02857142857142857
445,92311,7665,55,7720,0.9928756476683938,0.007124352331606218
446,92313,3010,24,3034,0.992089650626236,0.007910349373764008
447,92314,4148,4000,8148,0.5090819833087874,0.49091801669121254
448,92315,3737,4323,8060,0.4636476426799007,0.5363523573200992
449,92316,5525,126,5651,0.977703061405061,0.022296938594938948
450,92318,32,0,32,1.0,0.0
451,92320,3942,153,4095,0.9626373626373627,0.03736263736263736
452,92321,115,241,356,0.32303370786516855,0.6769662921348315
453,92322,117,469,586,0.19965870307167236,0.8003412969283277
455,92324,10509,288,10797,0.9733259238677411,0.026674076132258962
456,92325,1269,3891,5160,0.24593023255813953,0.7540697674418605
457,92327,96,0,96,1.0,0.0
459,92333,313,543,856,0.36565420560747663,0.6343457943925234
460,92335,14166,266,14432,0.9815687361419069,0.018431263858093128
461,92336,25577,164,25741,0.9936288411483626,0.0063711588516374654
462,92337,8042,99,8141,0.9878393317774229,0.01216066822257708
463,92339,230,377,607,0.37891268533772654,0.6210873146622735
464,92341,348,549,897,0.3879598662207358,0.6120401337792643
465,92342,2566,16,2582,0.9938032532920217,0.006196746707978312
466,92344,5723,342,6065,0.94361088211047,0.05638911788953009
467,92345,21261,191,21452,0.9910964012679471,0.008903598732052955
468,92346,13349,145,13494,0.9892544834741367,0.010745516525863346
469,92347,111,3,114,0.9736842105263158,0.02631578947368421
470,92352,2455,5872,8327,0.2948240662903807,0.7051759337096193
471,92354,4784,40,4824,0.9917081260364843,0.008291873963515755
472,92356,1554,51,1605,0.9682242990654205,0.03177570093457944
473,92358,125,177,302,0.4139072847682119,0.5860927152317881
474,92359,2235,120,2355,0.9490445859872612,0.050955414012738856
475,92363,2309,10,2319,0.9956877964639931,0.004312203536006899
477,92365,643,14,657,0.9786910197869102,0.0213089802130898
478,92368,162,4,166,0.9759036144578314,0.024096385542168676
479,92371,4296,328,4624,0.9290657439446367,0.07093425605536333
480,92372,1838,135,1973,0.9315762797769893,0.06842372022301065
481,92373,8009,326,8335,0.9608878224355129,0.0391121775644871
482,92374,10499,67,10566,0.993658905924664,0.006341094075335983
483,92376,14707,230,14937,0.9846019950458593,0.015398004954140725
484,92377,5185,44,5229,0.9915853891757507,0.008414610824249378
485,92378,65,152,217,0.2995391705069124,0.7004608294930875
486,92382,1148,2219,3367,0.340956340956341,0.659043659043659
488,92385,49,94,143,0.34265734265734266,0.6573426573426573
489,92386,1068,1391,2459,0.4343228954859699,0.5656771045140301
491,92391,312,826,1138,0.2741652021089631,0.7258347978910369
492,92392,16201,107,16308,0.993438803041452,0.006561196958547952
493,92394,8853,65,8918,0.9927113702623906,0.007288629737609329
494,92395,10844,98,10942,0.9910436848839335,0.008956315116066533
495,92397,1602,1051,2653,0.6038447041085564,0.39615529589144366
496,92398,300,4,304,0.9868421052631579,0.013157894736842105
497,92399,14296,885,15181,0.9417034450958435,0.058296554904156514
498,92401,205,14,219,0.9360730593607306,0.0639269406392694
499,92404,10593,339,10932,0.9689901207464325,0.031009879253567508
500,92405,5845,243,6088,0.9600854139290408,0.03991458607095926
501,92407,12823,532,13355,0.9601647323099962,0.03983526769000374
502,92408,2031,72,2103,0.9657631954350927,0.034236804564907276
503,92410,6649,324,6973,0.9535350638175821,0.0464649361824179
504,92411,4106,208,4314,0.951784886416319,0.04821511358368104
505,92501,4385,24,4409,0.9945565887956452,0.005443411204354729
506,92503,19009,203,19212,0.9894336872787841,0.010566312721215906
507,92504,11879,78,11957,0.9934766245713808,0.006523375428619219
508,92505,8944,50,8994,0.9944407382699577,0.00555926173004225
509,92506,13554,53,13607,0.9961049459836848,0.0038950540163151318
510,92507,9430,79,9509,0.9916920811862446,0.00830791881375539
511,92508,9129,26,9155,0.9971600218459858,0.0028399781540141998
512,92509,15948,235,16183,0.9854785886424026,0.014521411357597479
514,92530,13605,575,14180,0.9594499294781382,0.04055007052186178
515,92532,6597,228,6825,0.9665934065934066,0.03340659340659341
516,92536,902,247,1149,0.7850304612706701,0.21496953872932986
517,92539,765,357,1122,0.6818181818181818,0.3181818181818182
518,92543,8438,93,8531,0.9890985816434181,0.010901418356581878
519,92544,12098,430,12528,0.965676883780332,0.034323116219667944
520,92545,13524,125,13649,0.9908418199135468,0.00915818008645322
521,92548,1499,107,1606,0.9333748443337484,0.06662515566625156
522,92549,1291,2286,3577,0.36091696952753705,0.639083030472463
523,92551,6938,59,6997,0.9915678147777619,0.008432185222238101
524,92553,13556,122,13678,0.9910805673344056,0.008919432665594385
525,92555,10308,121,10429,0.9883977370792981,0.011602262920701888
526,92557,12637,161,12798,0.9874199093608377,0.01258009063916237
527,92561,575,195,770,0.7467532467532467,0.2532467532467532
528,92562,16281,721,17002,0.9575932243265498,0.042406775673450185
529,92563,19104,96,19200,0.995,0.005
530,92567,2218,108,2326,0.9535683576956148,0.046431642304385214
531,92570,9802,690,10492,0.9342356080823484,0.06576439191765154
532,92571,11508,155,11663,0.9867101088913659,0.013289891108634141
533,92582,5283,57,5340,0.9893258426966293,0.010674157303370787
534,92583,7373,76,7449,0.9897972882266076,0.010202711773392402
535,92584,17653,165,17818,0.9907397014255247,0.00926029857447525
536,92585,7658,41,7699,0.9946746330692298,0.00532536693077023
537,92586,8934,18,8952,0.9979892761394102,0.0020107238605898124
538,92587,5923,105,6028,0.9825812873258128,0.017418712674187126
539,92590,537,244,781,0.6875800256081946,0.31241997439180536
540,92591,10722,29,10751,0.9973025765045113,0.002697423495488792
541,92592,21813,406,22219,0.9817273504658175,0.018272649534182457
542,92595,8713,290,9003,0.9677885149394646,0.03221148506053538
543,92596,9332,58,9390,0.9938232161874334,0.00617678381256656
544,92602,5755,23,5778,0.9960193838698511,0.003980616130148841
545,92603,4115,20,4135,0.9951632406287787,0.0048367593712212815
546,92604,4660,3,4663,0.9993566373579241,0.0006433626420759168
547,92606,3195,1,3196,0.9996871088861077,0.00031289111389236547
548,92610,2996,41,3037,0.9864998353638459,0.0135001646361541
549,92612,1574,1,1575,0.9993650793650793,0.0006349206349206349
550,92614,3102,4,3106,0.9987121699935608,0.00128783000643915
551,92617,993,0,993,1.0,0.0
552,92618,9789,17,9806,0.9982663675300836,0.0017336324699163777
553,92620,12171,11,12182,0.9990970284025612,0.0009029715974388442
554,92624,2255,4,2259,0.9982293050022134,0.0017706949977866313
555,92625,4423,7,4430,0.9984198645598195,0.001580135440180587
556,92626,8817,4,8821,0.9995465366738465,0.00045346332615349736
557,92627,9748,14,9762,0.9985658676500717,0.0014341323499282934
558,92629,7229,8,7237,0.9988945695730275,0.0011054304269725024
559,92630,14090,24,14114,0.9982995607198526,0.0017004392801473714
560,92637,545,0,545,1.0,0.0
561,92646,14923,11,14934,0.9992634257399223,0.0007365742600776751
562,92647,11451,14,11465,0.9987788922808548,0.0012211077191452246
563,92648,8997,6,9003,0.9993335554815062,0.0006664445184938354
564,92649,8363,6,8369,0.9992830684669614,0.0007169315330385948
565,92651,8760,459,9219,0.9502115196876016,0.049788480312398305
566,92653,6266,13,6279,0.9979296066252588,0.002070393374741201
567,92655,1408,1,1409,0.9992902767920511,0.0007097232079489
568,92656,7537,37,7574,0.9951148666490626,0.004885133350937418
569,92657,3133,100,3233,0.9690689761831116,0.03093102381688834
570,92660,7209,15,7224,0.9979235880398671,0.0020764119601328905
571,92661,1683,4,1687,0.997628927089508,0.0023710729104919974
572,92662,1367,1,1368,0.9992690058479532,0.0007309941520467836
573,92663,5479,10,5489,0.99817817453088,0.0018218254691200583
574,92672,8901,37,8938,0.9958603714477512,0.004139628552248825
575,92673,7804,42,7846,0.9946469538618404,0.005353046138159572
576,92675,8415,58,8473,0.9931547267791809,0.006845273220819072
577,92676,156,550,706,0.22096317280453256,0.7790368271954674
578,92677,14861,112,14973,0.9925198690977092,0.0074801309022907905
579,92678,16,15,31,0.5161290322580645,0.4838709677419355
580,92679,8019,1052,9071,0.88402601697718,0.11597398302281997
581,92683,16837,20,16857,0.9988135492673667,0.0011864507326333274
582,92688,7872,52,7924,0.9934376577486118,0.006562342251388188
583,92691,11920,10,11930,0.9991617770326907,0.0008382229673093043
584,92692,12832,26,12858,0.9979779125836056,0.0020220874163944624
585,92694,7453,42,7495,0.9943962641761174,0.005603735823882588
586,92701,3818,77,3895,0.9802310654685494,0.019768934531450576
587,92703,7396,97,7493,0.9870545842786601,0.012945415721339917
588,92704,10533,82,10615,0.9922750824305229,0.007724917569477155
589,92705,9699,34,9733,0.9965067296825234,0.003493270317476626
590,92706,5507,6,5513,0.9989116633411935,0.0010883366588064574
591,92707,7554,77,7631,0.9899095793473988,0.010090420652601231
592,92708,13293,9,13302,0.9993234100135318,0.0006765899864682003
593,92780,7315,2,7317,0.999726663933306,0.00027333606669400026
594,92782,4483,12,4495,0.9973303670745273,0.0026696329254727474
595,92801,6802,20,6822,0.9970683084139549,0.002931691586045148
596,92802,4421,15,4436,0.9966185752930569,0.003381424706943192
597,92804,11474,22,11496,0.9980862908837856,0.0019137091162143354
598,92805,8715,24,8739,0.9972536903535874,0.0027463096464126332
599,92806,5357,11,5368,0.9979508196721312,0.0020491803278688526
600,92807,9178,67,9245,0.9927528393726338,0.007247160627366144
601,92808,4648,34,4682,0.992738146091414,0.007261853908586074
602,92821,8838,64,8902,0.9928106043585712,0.007189395641428892
603,92823,1380,55,1435,0.9616724738675958,0.03832752613240418
604,92831,5326,11,5337,0.9979389169945663,0.002061083005433764
605,92832,3846,7,3853,0.9981832338437581,0.0018167661562418895
606,92833,10168,22,10190,0.9978410206084396,0.0021589793915603533
607,92835,6157,11,6168,0.9982166018158236,0.0017833981841763942
608,92840,8946,6,8952,0.9993297587131368,0.0006702412868632708
609,92841,6013,2,6015,0.999667497921862,0.00033250207813798836
610,92843,6064,9,6073,0.998518030627367,0.0014819693726329656
611,92844,2763,1,2764,0.9996382054992764,0.000361794500723589
612,92845,4808,1,4809,0.9997920565606155,0.0002079434393844874
613,92860,6409,29,6438,0.9954954954954955,0.0045045045045045045
614,92861,1964,2,1966,0.9989827060020345,0.001017293997965412
616,92865,4257,10,4267,0.9976564330911648,0.002343566908835247
617,92866,3048,1,3049,0.9996720236142997,0.00032797638570022957
618,92867,9943,12,9955,0.9987945755901557,0.0012054244098442994
619,92868,2776,3,2779,0.998920474991004,0.0010795250089960418
620,92869,8215,25,8240,0.9969660194174758,0.003033980582524272
621,92870,10759,15,10774,0.9986077594208279,0.0013922405791720808
622,92879,9041,81,9122,0.9911203683402763,0.008879631659723745
623,92880,18446,70,18516,0.9962194858500756,0.0037805141499243898
624,92881,7843,69,7912,0.9912790697674418,0.00872093023255814
625,92882,14001,312,14313,0.9782016348773842,0.021798365122615803
626,92883,10984,269,11253,0.9760952634852929,0.02390473651470719
627,92886,13587,82,13669,0.9940010242153778,0.005998975784622137
628,92887,5210,217,5427,0.9600147411092684,0.039985258890731526
629,93001,7931,233,8164,0.9714600685938266,0.028539931406173443
630,93003,11794,44,11838,0.9962831559385031,0.0037168440614968744
631,93004,7911,12,7923,0.998485422188565,0.0015145778114350624
632,93010,11378,37,11415,0.9967586508979414,0.0032413491020586945
633,93012,8998,112,9110,0.9877058177826564,0.012294182217343578
634,93013,3659,125,3784,0.9669661733615222,0.0330338266384778
635,93015,4070,118,4188,0.9718242597898759,0.028175740210124166
636,93021,9216,176,9392,0.9812606473594548,0.018739352640545145
637,93022,1911,51,1962,0.9740061162079511,0.02599388379204893
638,93023,6296,525,6821,0.9230318135170796,0.07696818648292039
639,93030,9374,16,9390,0.9982960596379127,0.0017039403620873268
640,93033,10973,23,10996,0.9979083303019279,0.0020916696980720264
641,93035,7772,15,7787,0.9980737125979197,0.0019262874020803903
642,93036,6818,19,6837,0.9972210033640485,0.0027789966359514405
643,93040,366,19,385,0.9506493506493506,0.04935064935064935
644,93041,3127,5,3132,0.9984035759897829,0.0015964240102171138
645,93060,6541,210,6751,0.9688934972596652,0.031106502740334767
646,93063,13960,377,14337,0.9737044011996931,0.026295598800306897
647,93065,18231,210,18441,0.9886123312184806,0.01138766878151944
648,93066,705,59,764,0.9227748691099477,0.07722513089005235
649,93067,320,7,327,0.9785932721712538,0.021406727828746176
650,93101,4534,27,4561,0.9940802455601842,0.00591975443981583
651,93103,3873,173,4046,0.9572417202174988,0.042758279782501234
652,93105,5739,719,6458,0.8886652214307835,0.11133477856921647
653,93108,3002,664,3666,0.8188761593016912,0.18112384069830878
654,93109,3150,9,3159,0.9971509971509972,0.002849002849002849
655,93110,3964,32,3996,0.991991991991992,0.008008008008008008
656,93111,4761,59,4820,0.9877593360995851,0.012240663900414938
657,93117,6539,163,6702,0.9756789018203521,0.024321098179647865
658,93201,97,4,101,0.9603960396039604,0.039603960396039604
659,93202,981,1,982,0.9989816700610998,0.0010183299389002036
660,93203,3387,23,3410,0.9932551319648094,0.006744868035190616
661,93204,1399,2,1401,0.9985724482512491,0.0014275517487508922
662,93205,538,232,770,0.6987012987012987,0.3012987012987013
663,93206,293,5,298,0.9832214765100671,0.016778523489932886
664,93207,138,154,292,0.4726027397260274,0.5273972602739726
665,93208,75,44,119,0.6302521008403361,0.3697478991596639
666,93210,2961,19,2980,0.9936241610738255,0.0063758389261744965
667,93212,2703,19,2722,0.9930198383541513,0.0069801616458486405
668,93215,8213,29,8242,0.996481436544528,0.003518563455471973
669,93218,122,0,122,1.0,0.0
670,93219,1304,3,1307,0.9977046671767407,0.0022953328232593728
671,93221,3833,7,3840,0.9981770833333333,0.0018229166666666667
672,93222,935,664,1599,0.5847404627892433,0.4152595372107567
673,93223,2033,8,2041,0.9960803527682509,0.0039196472317491425
674,93224,111,0,111,1.0,0.0
675,93225,1996,407,2403,0.8306283811901789,0.16937161880982105
676,93226,59,20,79,0.7468354430379747,0.25316455696202533
677,93230,16732,13,16745,0.9992236488504032,0.0007763511495968945
678,93234,541,1,542,0.9981549815498155,0.0018450184501845018
679,93235,833,1,834,0.9988009592326139,0.001199040767386091
680,93238,815,82,897,0.9085841694537347,0.09141583054626533
681,93239,129,2,131,0.9847328244274809,0.015267175572519083
682,93240,2053,137,2190,0.9374429223744293,0.06255707762557078
683,93241,2145,17,2162,0.9921369102682701,0.00786308973172988
684,93242,434,0,434,1.0,0.0
685,93243,333,76,409,0.8141809290953546,0.18581907090464547
686,93244,103,4,107,0.9626168224299065,0.037383177570093455
687,93245,7171,2,7173,0.999721176634602,0.00027882336539802036
688,93247,3172,5,3177,0.998426188227888,0.0015738117721120553
689,93249,220,1,221,0.995475113122172,0.004524886877828055
690,93250,2551,6,2557,0.9976535001955417,0.0023464998044583495
692,93252,327,23,350,0.9342857142857143,0.06571428571428571
693,93254,177,15,192,0.921875,0.078125
694,93255,197,8,205,0.9609756097560975,0.03902439024390244
695,93256,746,8,754,0.9893899204244032,0.010610079575596816
696,93257,16027,76,16103,0.9952803825374154,0.004719617462584612
697,93260,171,191,362,0.4723756906077348,0.5276243093922652
698,93261,216,0,216,1.0,0.0
699,93262,49,5,54,0.9074074074074074,0.09259259259259259
700,93263,4798,10,4808,0.9979201331114809,0.0020798668885191347
701,93265,1555,418,1973,0.7881398884946782,0.21186011150532186
702,93266,249,0,249,1.0,0.0
703,93267,1025,5,1030,0.9951456310679612,0.0048543689320388345
704,93268,4079,45,4124,0.9890882638215325,0.010911736178467508
705,93270,872,10,882,0.9886621315192744,0.011337868480725623
706,93271,913,234,1147,0.7959895379250218,0.2040104620749782
707,93272,490,2,492,0.9959349593495935,0.0040650406504065045
708,93274,17521,33,17554,0.998120086589951,0.0018799134100489917
709,93276,75,1,76,0.9868421052631579,0.013157894736842105
710,93277,14081,4,14085,0.9997160099396522,0.00028399006034788784
711,93280,4466,8,4474,0.9982118909253465,0.001788109074653554
712,93283,701,42,743,0.9434724091520862,0.05652759084791386
713,93285,973,630,1603,0.6069868995633187,0.3930131004366812
714,93286,1947,10,1957,0.9948901379662749,0.005109862033725089
715,93287,45,7,52,0.8653846153846154,0.1346153846153846
716,93291,15173,42,15215,0.9972395662175485,0.002760433782451528
717,93292,11283,17,11300,0.9984955752212389,0.001504424778761062
718,93301,2323,34,2357,0.9855748833262622,0.014425116673737802
719,93304,10610,173,10783,0.9839562273949736,0.01604377260502643
720,93305,7113,172,7285,0.9763898421413865,0.02361015785861359
721,93306,17752,75,17827,0.9957928984125204,0.004207101587479666
722,93307,16145,277,16422,0.9831323833881379,0.016867616611862136
723,93308,12988,86,13074,0.9934220590484932,0.006577940951506807
724,93309,12255,27,12282,0.9978016609672692,0.0021983390327308255
725,93311,15422,10,15432,0.9993519958527735,0.0006480041472265422
726,93312,17744,14,17758,0.9992116229305102,0.0007883770694898074
727,93313,15234,28,15262,0.9981653780631634,0.0018346219368365875
728,93314,9858,14,9872,0.998581847649919,0.0014181523500810373
729,93401,8431,74,8505,0.9912992357436802,0.008700764256319812
730,93402,5397,30,5427,0.9944720840243229,0.00552791597567717
731,93405,4846,51,4897,0.9895854604860118,0.010414539513988156
732,93420,9868,127,9995,0.9872936468234117,0.012706353176588294
733,93422,9682,161,9843,0.9836431982119272,0.016356801788072743
734,93424,520,21,541,0.9611829944547134,0.038817005545286505
735,93426,624,286,910,0.6857142857142857,0.3142857142857143
736,93427,1554,27,1581,0.9829222011385199,0.017077798861480076
737,93428,3480,120,3600,0.9666666666666667,0.03333333333333333
738,93429,27,5,32,0.84375,0.15625
739,93430,1865,23,1888,0.9878177966101694,0.012182203389830509
740,93432,363,51,414,0.8768115942028986,0.12318840579710146
741,93433,3898,3,3901,0.999230966418867,0.0007690335811330429
742,93434,1720,13,1733,0.9924985574148875,0.0075014425851125215
744,93436,12035,97,12132,0.9920046158918563,0.007995384108143752
745,93440,394,14,408,0.9656862745098039,0.03431372549019608
746,93441,276,49,325,0.8492307692307692,0.15076923076923077
747,93442,4883,16,4899,0.9967340273525209,0.0032659726474790775
748,93444,6925,23,6948,0.9966896948762234,0.0033103051237766265
749,93445,2024,0,2024,1.0,0.0
750,93446,14437,176,14613,0.98795592965168,0.01204407034831999
751,93449,4147,12,4159,0.997114691031498,0.002885308968502044
752,93450,86,5,91,0.945054945054945,0.054945054945054944
753,93451,1218,33,1251,0.973621103117506,0.026378896882494004
754,93452,62,10,72,0.8611111111111112,0.1388888888888889
755,93453,779,113,892,0.8733183856502242,0.1266816143497758
756,93454,7962,62,8024,0.9922731804586241,0.007726819541375872
757,93455,13563,14,13577,0.9989688443691537,0.0010311556308462842
758,93458,8615,3,8618,0.9996518913901137,0.0003481086098862845
759,93460,1654,110,1764,0.937641723356009,0.06235827664399093
760,93461,374,2,376,0.9946808510638298,0.005319148936170213
761,93463,2377,22,2399,0.9908295122967903,0.00917048770320967
762,93465,3130,33,3163,0.989566866898514,0.010433133101485931
763,93501,1235,17,1252,0.9864217252396166,0.013578274760383386
764,93505,4078,21,4099,0.9948767992193218,0.005123200780678214
765,93510,2085,270,2355,0.8853503184713376,0.11464968152866242
766,93512,46,3,49,0.9387755102040817,0.061224489795918366
767,93513,584,2,586,0.9965870307167235,0.0034129692832764505
768,93514,4265,30,4295,0.9930151338766007,0.006984866123399301
769,93516,588,6,594,0.98989898989899,0.010101010101010102
770,93517,464,41,505,0.9188118811881189,0.08118811881188119
771,93518,349,111,460,0.758695652173913,0.24130434782608695
774,93523,353,4,357,0.988795518207283,0.011204481792717087
775,93526,305,4,309,0.9870550161812298,0.012944983818770227
776,93527,751,26,777,0.9665379665379665,0.03346203346203346
777,93528,38,4,42,0.9047619047619048,0.09523809523809523
778,93529,386,162,548,0.7043795620437956,0.2956204379562044
780,93531,151,84,235,0.6425531914893617,0.3574468085106383
781,93532,598,360,958,0.6242171189979123,0.3757828810020877
782,93534,8136,52,8188,0.9936492427943332,0.006350757205666829
783,93535,16997,137,17134,0.9920042021711217,0.007995797828878253
784,93536,19024,103,19127,0.9946149422282637,0.005385057771736289
785,93541,141,31,172,0.8197674418604651,0.18023255813953487
786,93543,3267,58,3325,0.9825563909774436,0.01744360902255639
787,93544,361,30,391,0.9232736572890026,0.07672634271099744
788,93545,574,12,586,0.9795221843003413,0.020477815699658702
789,93546,3029,264,3293,0.9198299423018524,0.08017005769814758
790,93549,69,2,71,0.971830985915493,0.028169014084507043
791,93550,15199,202,15401,0.9868839685734693,0.013116031426530745
792,93551,15572,261,15833,0.9835154424303669,0.016484557569633046
793,93552,9631,74,9705,0.992375064399794,0.0076249356002060795
794,93553,553,19,572,0.9667832167832168,0.033216783216783216
796,93555,10161,16,10177,0.9984278274540631,0.0015721725459369165
798,93560,5756,22,5778,0.9961924541363794,0.00380754586362063
799,93561,10042,853,10895,0.9217072051399725,0.07829279486002753
800,93562,359,3,362,0.9917127071823204,0.008287292817679558
801,93563,23,8,31,0.7419354838709677,0.25806451612903225
802,93591,1793,24,1817,0.9867914144193726,0.013208585580627407
803,93601,541,188,729,0.7421124828532236,0.2578875171467764
804,93602,631,469,1100,0.5736363636363636,0.4263636363636364
805,93603,49,49,98,0.5,0.5
806,93604,683,328,1011,0.675568743818002,0.32443125618199803
807,93605,38,27,65,0.5846153846153846,0.4153846153846154
808,93606,188,1,189,0.9947089947089947,0.005291005291005291
809,93608,136,2,138,0.9855072463768116,0.014492753623188406
810,93609,785,6,791,0.9924146649810367,0.007585335018963337
811,93610,3694,9,3703,0.9975695382122604,0.0024304617877396704
812,93611,13860,3,13863,0.9997835966241073,0.00021640337589266391
813,93612,7211,4,7215,0.9994455994455994,0.0005544005544005544
814,93614,3617,743,4360,0.8295871559633028,0.17041284403669724
815,93615,801,4,805,0.9950310559006211,0.004968944099378882
816,93616,342,2,344,0.9941860465116279,0.005813953488372093
817,93618,5897,5,5902,0.9991528295493053,0.0008471704506946798
818,93619,16496,100,16596,0.9939744516751025,0.006025548324897566
819,93620,2094,3,2097,0.9985693848354793,0.001430615164520744
820,93621,70,14,84,0.8333333333333334,0.16666666666666666
821,93622,1533,8,1541,0.9948085658663206,0.005191434133679429
822,93623,88,64,152,0.5789473684210527,0.42105263157894735
824,93625,1761,4,1765,0.9977337110481587,0.0022662889518413596
825,93626,749,63,812,0.9224137931034483,0.07758620689655173
827,93628,151,68,219,0.6894977168949772,0.3105022831050228
828,93630,3441,18,3459,0.99479618386817,0.005203816131830009
829,93631,4060,4,4064,0.9990157480314961,0.000984251968503937
830,93633,79,56,135,0.5851851851851851,0.4148148148148148
831,93634,239,111,350,0.6828571428571428,0.3171428571428571
832,93635,15334,5,15339,0.9996740335093552,0.0003259664906447617
833,93636,5336,12,5348,0.9977561705310396,0.002243829468960359
834,93637,8749,14,8763,0.9984023736163414,0.0015976263836585643
835,93638,9165,26,9191,0.9971711456859972,0.002828854314002829
836,93640,1709,10,1719,0.9941826643397323,0.005817335660267597
837,93641,110,57,167,0.6586826347305389,0.3413173652694611
838,93643,644,553,1197,0.5380116959064327,0.4619883040935672
839,93644,2579,810,3389,0.7609914429035114,0.23900855709648863
840,93646,1309,19,1328,0.9856927710843374,0.01430722891566265
841,93647,1644,14,1658,0.991556091676719,0.008443908323281062
842,93648,2332,0,2332,1.0,0.0
843,93650,907,9,916,0.990174672489083,0.009825327510917031
844,93651,445,77,522,0.8524904214559387,0.1475095785440613
845,93652,42,1,43,0.9767441860465116,0.023255813953488372
846,93653,276,61,337,0.8189910979228486,0.18100890207715134
847,93654,5718,11,5729,0.9980799441438296,0.0019200558561703613
848,93656,951,2,953,0.9979013641133263,0.002098635886673662
849,93657,8090,30,8120,0.9963054187192119,0.003694581280788177
850,93660,534,1,535,0.9981308411214953,0.001869158878504673
851,93662,5712,8,5720,0.9986013986013986,0.0013986013986013986
852,93664,1015,1214,2229,0.45536114849708387,0.5446388515029161
853,93665,89,0,89,1.0,0.0
854,93666,37,0,37,1.0,0.0
855,93667,509,185,694,0.7334293948126801,0.2665706051873199
856,93668,189,1,190,0.9947368421052631,0.005263157894736842
857,93669,109,107,216,0.5046296296296297,0.49537037037037035
858,93673,92,0,92,1.0,0.0
859,93675,958,130,1088,0.8805147058823529,0.11948529411764706
860,93701,1317,29,1346,0.9784546805349182,0.021545319465081723
861,93702,6888,117,7005,0.9832976445396145,0.01670235546038544
862,93703,6072,29,6101,0.9952466808719882,0.0047533191280118015
863,93704,7195,20,7215,0.9972279972279973,0.002772002772002772
864,93705,7644,11,7655,0.9985630306988896,0.0014369693011103853
865,93706,5271,67,5338,0.9874484825777444,0.012551517422255526
866,93710,5717,3,5720,0.9994755244755245,0.0005244755244755245
867,93711,10427,7,10434,0.9993291163503929,0.0006708836496070539
868,93720,12998,1,12999,0.999923071005462,7.692899453804139e-05
869,93721,225,6,231,0.974025974025974,0.025974025974025976
870,93722,19700,18,19718,0.9990871285120195,0.0009128714879805254
871,93723,3300,9,3309,0.9972801450589301,0.0027198549410698096
872,93725,4316,32,4348,0.9926402943882244,0.007359705611775529
873,93726,7618,5,7623,0.9993440902531812,0.0006559097468188378
874,93727,17861,17,17878,0.9990491106387739,0.0009508893612260879
875,93728,3718,38,3756,0.9898828541001065,0.010117145899893504
876,93730,4838,2,4840,0.9995867768595041,0.00041322314049586776
877,93737,2022,2,2024,0.9990118577075099,0.0009881422924901185
878,93901,5578,4,5582,0.9992834109638122,0.0007165890361877463
879,93905,7899,3,7902,0.9996203492786636,0.00037965072133637056
880,93906,10899,2,10901,0.9998165305935235,0.00018346940647647004
881,93907,5510,243,5753,0.9577611680862159,0.042238831913784115
882,93908,3857,246,4103,0.9400438703387765,0.059956129661223496
883,93920,157,104,261,0.6015325670498084,0.39846743295019155
884,93921,1673,57,1730,0.9670520231213873,0.032947976878612714
885,93923,5211,604,5815,0.8961306964746346,0.10386930352536543
886,93924,1955,477,2432,0.8038651315789473,0.19613486842105263
887,93925,206,14,220,0.9363636363636364,0.06363636363636363
888,93926,1559,6,1565,0.9961661341853035,0.0038338658146964857
889,93927,3113,53,3166,0.9832596336070751,0.016740366392924828
891,93930,2867,33,2900,0.9886206896551725,0.011379310344827587
892,93932,136,8,144,0.9444444444444444,0.05555555555555555
893,93933,5065,9,5074,0.9982262514781237,0.0017737485218762318
894,93940,7214,160,7374,0.978302142663412,0.021697857336588012
895,93950,5144,2,5146,0.9996113486202876,0.000388651379712398
896,93953,2452,53,2505,0.9788423153692615,0.021157684630738523
897,93954,51,2,53,0.9622641509433962,0.03773584905660377
898,93955,6118,1,6119,0.9998365746036935,0.00016342539630658605
899,93960,3545,15,3560,0.9957865168539326,0.004213483146067416
900,94002,6521,11,6532,0.9983159828536436,0.0016840171463563993
901,94005,1148,11,1159,0.9905090595340811,0.009490940465918895
902,94010,13884,46,13930,0.9966977745872219,0.0033022254127781764
903,94014,8840,14,8854,0.9984187937655297,0.001581206234470296
904,94015,12393,8,12401,0.9993548907346181,0.0006451092653818241
905,94019,4439,53,4492,0.9882012466607302,0.011798753339269812
906,94020,461,77,538,0.8568773234200744,0.14312267657992564
907,94021,53,20,73,0.726027397260274,0.273972602739726
908,94022,5874,72,5946,0.987891019172553,0.012108980827447022
909,94024,7399,56,7455,0.9924882629107982,0.007511737089201878
910,94025,10260,17,10277,0.9983458207648146,0.0016541792351853653
911,94027,2448,5,2453,0.9979616795760293,0.0020383204239706482
912,94028,2187,68,2255,0.9698447893569845,0.03015521064301552
913,94030,5525,5,5530,0.9990958408679927,0.0009041591320072332
914,94037,851,10,861,0.9883855981416957,0.011614401858304297
915,94038,986,2,988,0.9979757085020243,0.0020242914979757085
916,94040,5154,3,5157,0.9994182664339732,0.0005817335660267597
917,94041,2607,0,2607,1.0,0.0
918,94043,3893,1,3894,0.9997431946584489,0.00025680534155110427
919,94044,10476,79,10555,0.9925153955471341,0.007484604452865941
920,94060,306,86,392,0.7806122448979592,0.2193877551020408
921,94061,8055,3,8058,0.9996276991809382,0.00037230081906180194
922,94062,8239,167,8406,0.9801332381632167,0.01986676183678325
923,94063,4039,12,4051,0.997037768452234,0.0029622315477659837
924,94065,2217,0,2217,1.0,0.0
925,94066,9617,2,9619,0.9997920781786048,0.00020792182139515541
926,94070,8485,25,8510,0.9970622796709753,0.002937720329024677
927,94074,54,12,66,0.8181818181818182,0.18181818181818182
928,94080,13781,3,13784,0.9997823563551944,0.00021764364480557168
929,94085,2727,0,2727,1.0,0.0
930,94086,6640,4,6644,0.9993979530403372,0.0006020469596628537
931,94087,12168,1,12169,0.9999178239789629,8.217602103706138e-05
932,94089,4546,0,4546,1.0,0.0
933,94102,559,7,566,0.9876325088339223,0.012367491166077738
934,94103,963,24,987,0.9756838905775076,0.0243161094224924
936,94105,264,0,264,1.0,0.0
937,94107,2418,11,2429,0.9954713874022232,0.004528612597776863
938,94108,243,3,246,0.9878048780487805,0.012195121951219513
939,94109,1591,16,1607,0.9900435594275047,0.009956440572495333
940,94110,9288,98,9386,0.9895589175367568,0.010441082463243129
941,94111,59,0,59,1.0,0.0
942,94112,17048,33,17081,0.9980680288039342,0.0019319711960658042
943,94114,5803,33,5836,0.994345442083619,0.005654557916381083
944,94115,2354,27,2381,0.9886602267954641,0.01133977320453591
945,94116,12915,15,12930,0.9988399071925754,0.001160092807424594
946,94117,3367,47,3414,0.986233157586409,0.013766842413591095
947,94118,6064,27,6091,0.9955672303398456,0.004432769660154326
948,94121,10054,13,10067,0.9987086520313897,0.0012913479686103109
949,94122,13338,22,13360,0.9983532934131737,0.0016467065868263472
950,94123,2813,25,2838,0.9911909795630726,0.008809020436927413
951,94124,5648,36,5684,0.9936664320900774,0.0063335679099225895
952,94127,6764,4,6768,0.9994089834515366,0.000591016548463357
954,94131,6778,17,6795,0.9974981604120677,0.002501839587932303
955,94132,4653,9,4662,0.9980694980694981,0.0019305019305019305
956,94133,1592,26,1618,0.9839307787391842,0.016069221260815822
957,94134,8066,17,8083,0.9978968204874428,0.002103179512557219
958,94158,91,6,97,0.9381443298969072,0.061855670103092786
959,94301,4185,9,4194,0.9978540772532188,0.002145922746781116
960,94303,8718,19,8737,0.9978253405058944,0.0021746594941055284
961,94304,202,5,207,0.9758454106280193,0.024154589371980676
962,94305,641,2,643,0.9968895800933126,0.003110419906687403
963,94306,6287,3,6290,0.9995230524642289,0.0004769475357710652
964,94401,4741,7,4748,0.9985256950294861,0.0014743049705139006
965,94402,6683,12,6695,0.9982076176250934,0.0017923823749066467
966,94403,8905,1,8906,0.9998877161464181,0.00011228385358185493
967,94404,5656,2,5658,0.9996465182043125,0.0003534817956875221
968,94501,11583,89,11672,0.99237491432488,0.007625085675119945
969,94502,3312,0,3312,1.0,0.0
970,94503,5129,1,5130,0.9998050682261208,0.0001949317738791423
971,94505,5706,3,5709,0.999474513925381,0.0005254860746190226
972,94506,7267,51,7318,0.9930308827548511,0.0069691172451489475
973,94507,5220,54,5274,0.9897610921501706,0.010238907849829351
974,94508,601,162,763,0.7876802096985583,0.21231979030144169
975,94509,16667,39,16706,0.9976655093978212,0.002334490602178858
976,94510,7818,4,7822,0.9994886218358476,0.0005113781641523907
977,94511,738,27,765,0.9647058823529412,0.03529411764705882
978,94512,72,1,73,0.9863013698630136,0.0136986301369863
979,94513,20354,20,20374,0.9990183567291646,0.0009816432708353784
980,94514,407,4,411,0.9902676399026764,0.009732360097323601
981,94515,2142,205,2347,0.9126544524925436,0.08734554750745632
982,94516,27,14,41,0.6585365853658537,0.34146341463414637
983,94517,3968,26,3994,0.9934902353530295,0.006509764646970456
984,94518,7198,24,7222,0.9966768208252562,0.003323179174743838
985,94519,5729,10,5739,0.9982575361561248,0.0017424638438752395
986,94520,5365,5,5370,0.9990689013035382,0.000931098696461825
987,94521,11589,5,11594,0.9995687424529929,0.0004312575470070726
988,94523,8847,10,8857,0.9988709495314441,0.0011290504685559444
989,94525,1105,15,1120,0.9866071428571429,0.013392857142857142
990,94526,9765,24,9789,0.9975482684646031,0.002451731535396874
991,94528,295,6,301,0.9800664451827242,0.019933554817275746
992,94530,7665,32,7697,0.9958425360530077,0.0041574639469923345
993,94531,12742,6,12748,0.9995293379353624,0.0004706620646375902
994,94533,17724,5,17729,0.999717976197191,0.00028202380280895707
995,94534,12441,34,12475,0.9972745490981964,0.0027254509018036074
996,94536,14214,10,14224,0.9992969628796401,0.000703037120359955
997,94538,10405,4,10409,0.9996157171678355,0.0003842828321644731
998,94539,13585,7,13592,0.9994849911712772,0.0005150088287227781
999,94541,11466,79,11545,0.9931572109138155,0.0068427890861844955
1000,94542,3698,30,3728,0.9919527896995708,0.008047210300429184
1001,94544,13068,17,13085,0.9987008024455484,0.0012991975544516623
1002,94545,7513,12,7525,0.998405315614618,0.0015946843853820599
1003,94546,11601,17,11618,0.9985367533138234,0.0014632466861766225
1004,94547,5947,3,5950,0.9994957983193278,0.0005042016806722689
1005,94548,90,0,90,1.0,0.0
1006,94549,8659,146,8805,0.9834185122089721,0.016581487791027825
1007,94550,14559,32,14591,0.997806867246933,0.002193132753066959
1008,94551,9900,17,9917,0.9982857719068267,0.0017142280931733388
1009,94552,4100,98,4198,0.9766555502620295,0.023344449737970462
1010,94553,14341,43,14384,0.9970105672969967,0.002989432703003337
1011,94555,8193,2,8195,0.9997559487492373,0.00024405125076266016
1012,94556,4331,23,4354,0.9947175011483693,0.005282498851630684
1013,94558,18587,327,18914,0.982711219202707,0.01728878079729301
1014,94559,6943,22,6965,0.9968413496051687,0.0031586503948312994
1015,94560,11060,7,11067,0.9993674889310563,0.0006325110689437065
1016,94561,12840,41,12881,0.9968170173123204,0.003182982687679528
1017,94563,6534,194,6728,0.9711652794292509,0.02883472057074911
1018,94564,5253,7,5260,0.9986692015209125,0.0013307984790874524
1019,94565,21486,50,21536,0.9976783060921248,0.0023216939078751857
1020,94566,11695,12,11707,0.9989749722388315,0.0010250277611685316
1021,94567,112,128,240,0.4666666666666667,0.5333333333333333
1022,94568,13430,7,13437,0.9994790503832701,0.0005209496167299249
1023,94569,62,2,64,0.96875,0.03125
1024,94571,4886,1,4887,0.9997953754859832,0.0002046245140167792
1025,94572,2367,13,2380,0.9945378151260504,0.0054621848739495795
1026,94573,32,10,42,0.7619047619047619,0.23809523809523808
1027,94574,2530,246,2776,0.9113832853025937,0.08861671469740634
1028,94576,43,12,55,0.7818181818181819,0.21818181818181817
1029,94577,10709,23,10732,0.9978568766306374,0.0021431233693626536
1030,94578,6792,11,6803,0.998383066294282,0.0016169337057180655
1031,94579,5910,2,5912,0.9996617050067659,0.00033829499323410016
1032,94580,7415,7,7422,0.9990568579897602,0.0009431420102398275
1033,94582,9972,1,9973,0.9998997292690264,0.0001002707309736288
1034,94583,9618,35,9653,0.9963741841914431,0.0036258158085569255
1035,94585,7849,10,7859,0.9987275734826314,0.001272426517368622
1036,94586,287,36,323,0.8885448916408669,0.11145510835913312
1037,94587,14823,5,14828,0.999662800107904,0.0003371998920960345
1038,94588,7255,16,7271,0.9977994773758768,0.002200522624123229
1039,94589,7572,10,7582,0.9986810867844896,0.0013189132155104195
1040,94590,8792,52,8844,0.9941203075531434,0.005879692446856626
1041,94591,15584,28,15612,0.9982065078145017,0.0017934921854983346
1042,94592,369,0,369,1.0,0.0
1043,94595,2598,23,2621,0.9912247233880198,0.00877527661198016
1044,94596,4032,9,4041,0.9977728285077951,0.0022271714922048997
1045,94597,3954,20,3974,0.9949672873678913,0.0050327126321087065
1046,94598,7152,11,7163,0.9984643305877425,0.001535669412257434
1047,94599,895,5,900,0.9944444444444445,0.005555555555555556
1048,94601,7443,172,7615,0.9774130006565989,0.022586999343401182
1049,94602,8117,78,8195,0.9904820012202562,0.009517998779743747
1050,94603,6805,94,6899,0.9863748369328889,0.013625163067111175
1051,94605,10918,170,11088,0.9846681096681097,0.015331890331890332
1052,94606,4768,102,4870,0.9790554414784394,0.020944558521560575
1053,94607,2359,80,2439,0.96719967199672,0.03280032800328003
1054,94608,4846,80,4926,0.9837596427121397,0.016240357287860333
1055,94609,4120,60,4180,0.9856459330143541,0.014354066985645933
1056,94610,5052,24,5076,0.9952718676122931,0.004728132387706856
1057,94611,9564,932,10496,0.911204268292683,0.08879573170731707
1058,94612,444,23,467,0.9507494646680942,0.04925053533190578
1059,94618,5067,11,5078,0.9978337928318236,0.0021662071681764474
1060,94619,7082,100,7182,0.9860763018657756,0.01392369813422445
1061,94621,5624,117,5741,0.9796202752133775,0.02037972478662254
1062,94702,4382,22,4404,0.9950045413260672,0.004995458673932788
1063,94703,4089,37,4126,0.9910324769752787,0.00896752302472128
1064,94704,958,26,984,0.9735772357723578,0.026422764227642278
1065,94705,3509,100,3609,0.972291493488501,0.02770850651149903
1066,94706,4419,7,4426,0.9984184365115228,0.0015815634884771804
1067,94707,4723,22,4745,0.99536354056902,0.004636459430979979
1068,94708,4196,131,4327,0.9697249826669748,0.030275017333025192
1069,94709,1170,27,1197,0.9774436090225563,0.022556390977443608
1070,94710,1388,25,1413,0.9823071479122435,0.017692852087756547
1071,94801,5345,106,5451,0.9805540267840763,0.019445973215923684
1072,94803,7192,48,7240,0.9933701657458563,0.0066298342541436465
1073,94804,9282,65,9347,0.9930458970792768,0.006954102920723227
1074,94805,4342,28,4370,0.9935926773455378,0.006407322654462242
1075,94806,11395,79,11474,0.9931148683981175,0.006885131601882517
1076,94901,8528,27,8555,0.9968439509059029,0.0031560490940970194
1077,94903,7250,13,7263,0.9982101060167975,0.0017898939832025334
1078,94904,3046,32,3078,0.9896036387264457,0.010396361273554255
1079,94920,3741,15,3756,0.9960063897763578,0.003993610223642172
1080,94922,79,11,90,0.8777777777777778,0.12222222222222222
1081,94923,1232,23,1255,0.9816733067729083,0.018326693227091632
1082,94924,594,7,601,0.9883527454242929,0.011647254575707155
1083,94925,2650,28,2678,0.9895444361463779,0.010455563853622106
1084,94928,10098,3,10101,0.9997029997029997,0.000297000297000297
1085,94929,279,4,283,0.9858657243816255,0.014134275618374558
1086,94930,2759,48,2807,0.982899893124332,0.017100106875667972
1087,94931,2325,0,2325,1.0,0.0
1088,94933,241,28,269,0.895910780669145,0.10408921933085502
1089,94937,597,204,801,0.7453183520599251,0.2546816479400749
1090,94938,190,23,213,0.892018779342723,0.107981220657277
1091,94939,1813,23,1836,0.9874727668845316,0.01252723311546841
1092,94940,77,10,87,0.8850574712643678,0.11494252873563218
1093,94941,9046,253,9299,0.9727927734164964,0.027207226583503604
1094,94945,5090,12,5102,0.9976479811838495,0.002352018816150529
1095,94946,193,28,221,0.8733031674208145,0.12669683257918551
1096,94947,6412,20,6432,0.9968905472636815,0.003109452736318408
1097,94949,3880,17,3897,0.9956376700025661,0.0043623299974339235
1099,94951,1367,13,1380,0.9905797101449275,0.009420289855072464
1100,94952,9745,34,9779,0.9965231618774926,0.003476838122507414
1101,94954,10627,14,10641,0.9986843341791185,0.0013156658208814962
1102,94956,434,31,465,0.9333333333333333,0.06666666666666667
1103,94957,601,5,606,0.9917491749174917,0.00825082508250825
1104,94960,5002,20,5022,0.9960175228992433,0.00398247710075667
1105,94963,180,6,186,0.967741935483871,0.03225806451612903
1107,94965,2268,326,2594,0.874325366229761,0.12567463377023902
1108,94970,626,8,634,0.9873817034700315,0.012618296529968454
1109,94971,70,3,73,0.958904109589041,0.0410958904109589
1110,94972,49,0,49,1.0,0.0
1111,94973,406,35,441,0.9206349206349206,0.07936507936507936
1112,95002,348,5,353,0.9858356940509915,0.014164305949008499
1113,95003,8733,202,8935,0.9773922775601567,0.02260772243984331
1114,95004,1137,26,1163,0.9776440240756664,0.02235597592433362
1115,95005,1998,227,2225,0.8979775280898876,0.10202247191011236
1116,95006,2828,475,3303,0.8561913412049652,0.14380865879503482
1117,95007,194,34,228,0.8508771929824561,0.14912280701754385
1118,95008,9458,2,9460,0.9997885835095137,0.00021141649048625792
1119,95010,2666,0,2666,1.0,0.0
1120,95012,1688,11,1699,0.9935256032960565,0.006474396703943496
1122,95014,12930,67,12997,0.9948449642225129,0.0051550357774871125
1123,95017,143,10,153,0.934640522875817,0.06535947712418301
1124,95018,2476,375,2851,0.8684672044896528,0.13153279551034724
1125,95019,983,0,983,1.0,0.0
1126,95020,14569,62,14631,0.9957624222541179,0.004237577745882032
1127,95023,14178,39,14217,0.9972568052331715,0.002743194766828445
1128,95030,4009,207,4216,0.9509013282732448,0.049098671726755215
1129,95032,7000,59,7059,0.9916418756197761,0.008358124380223828
1130,95033,2828,526,3354,0.8431723315444246,0.15682766845557544
1131,95035,13216,7,13223,0.9994706193753309,0.0005293806246691371
1132,95037,12501,155,12656,0.9877528445006322,0.012247155499367888
1133,95039,260,1,261,0.9961685823754789,0.0038314176245210726
1134,95041,149,25,174,0.8563218390804598,0.14367816091954022
1135,95043,97,38,135,0.7185185185185186,0.2814814814814815
1136,95045,1077,25,1102,0.9773139745916516,0.022686025408348458
1137,95046,1448,6,1454,0.9958734525447043,0.0041265474552957355
1138,95050,6543,3,6546,0.9995417048579285,0.00045829514207149406
1139,95051,10758,1,10759,0.9999070545589739,9.294544102611767e-05
1140,95054,2866,0,2866,1.0,0.0
1141,95060,11343,231,11574,0.9800414722654225,0.0199585277345775
1142,95062,10435,13,10448,0.9987557427258805,0.0012442572741194486
1143,95064,108,1,109,0.9908256880733946,0.009174311926605505
1144,95065,2226,85,2311,0.9632193855473821,0.03678061445261791
1145,95066,4331,218,4549,0.9520773796438777,0.04792262035612223
1146,95070,9779,128,9907,0.9870798425355809,0.012920157464419097
1147,95073,3199,151,3350,0.9549253731343283,0.045074626865671645
1148,95075,157,2,159,0.9874213836477987,0.012578616352201259
1149,95076,15969,211,16180,0.9869592088998764,0.013040791100123609
1150,95110,2371,38,2409,0.9842258198422582,0.0157741801577418
1151,95111,9568,23,9591,0.9976019184652278,0.002398081534772182
1152,95112,7002,111,7113,0.9843947701391818,0.01560522986081822
1153,95113,31,0,31,1.0,0.0
1154,95116,6401,79,6480,0.9878086419753086,0.012191358024691358
1155,95117,3802,2,3804,0.9994742376445847,0.0005257623554153522
1156,95118,7961,102,8063,0.9873496217288851,0.01265037827111497
1157,95119,2730,0,2730,1.0,0.0
1158,95120,11673,31,11704,0.9973513328776487,0.002648667122351333
1159,95121,7780,13,7793,0.9983318362633132,0.0016681637366867702
1160,95122,8106,34,8140,0.9958230958230958,0.004176904176904177
1161,95123,14175,7,14182,0.9995064165844028,0.0004935834155972359
1162,95124,13964,3,13967,0.9997852079902627,0.00021479200973723776
1163,95125,13558,21,13579,0.9984534943663009,0.0015465056336990942
1164,95126,4586,30,4616,0.9935008665511266,0.006499133448873483
1165,95127,12202,56,12258,0.9954315549029206,0.004568445097079458
1166,95128,6600,8,6608,0.9987893462469734,0.0012106537530266344
1167,95129,8586,6,8592,0.9993016759776536,0.0006983240223463687
1168,95130,3461,1,3462,0.9997111496244945,0.00028885037550548814
1169,95131,5412,2,5414,0.9996305873660879,0.0003694126339120798
1170,95132,9818,10,9828,0.998982498982499,0.0010175010175010174
1171,95133,4382,4,4386,0.9990880072959416,0.0009119927040583675
1172,95134,966,1,967,0.9989658738366081,0.001034126163391934
1173,95135,4361,1,4362,0.9997707473635947,0.00022925263640531865
1174,95136,8169,0,8169,1.0,0.0
1175,95138,4578,5,4583,0.9989090115644774,0.0010909884355225835
1176,95139,1778,1,1779,0.9994378864530635,0.0005621135469364812
1177,95140,100,17,117,0.8547008547008547,0.1452991452991453
1179,95148,10754,9,10763,0.9991638019139645,0.000836198086035492
1180,95202,494,26,520,0.95,0.05
1181,95203,3388,67,3455,0.9806078147612156,0.01939218523878437
1182,95204,8843,34,8877,0.9961698772107694,0.003830122789230596
1183,95205,7537,120,7657,0.9843280658221235,0.01567193417787645
1184,95206,14516,95,14611,0.9934980494148244,0.006501950585175552
1185,95207,9092,11,9103,0.998791607162474,0.0012083928375260903
1186,95209,11728,8,11736,0.9993183367416496,0.0006816632583503749
1187,95210,8252,5,8257,0.9993944531912317,0.0006055468087683178
1188,95212,7159,3,7162,0.9995811225914549,0.0004188774085450991
1189,95215,4839,35,4874,0.9928190398030365,0.0071809601969634795
1190,95219,7549,5,7554,0.9993380990203865,0.0006619009796134498
1191,95220,1731,0,1731,1.0,0.0
1192,95222,1761,268,2029,0.8679152291769344,0.13208477082306555
1193,95223,3712,3484,7196,0.5158421345191774,0.4841578654808227
1194,95224,113,82,195,0.5794871794871795,0.4205128205128205
1195,95225,196,14,210,0.9333333333333333,0.06666666666666667
1197,95227,146,2,148,0.9864864864864865,0.013513513513513514
1198,95228,2270,307,2577,0.8808692277842453,0.11913077221575476
1199,95229,21,14,35,0.6,0.4
1200,95230,84,3,87,0.9655172413793104,0.034482758620689655
1201,95231,553,1,554,0.9981949458483754,0.0018050541516245488
1202,95232,93,35,128,0.7265625,0.2734375
1203,95233,98,122,220,0.44545454545454544,0.5545454545454546
1204,95236,892,0,892,1.0,0.0
1205,95237,974,0,974,1.0,0.0
1206,95240,10152,6,10158,0.9994093325457767,0.0005906674542232723
1207,95242,8576,1,8577,0.999883409117407,0.00011659088259298122
1208,95245,586,194,780,0.7512820512820513,0.24871794871794872
1209,95246,453,210,663,0.6832579185520362,0.3167420814479638
1210,95247,1385,808,2193,0.6315549475604195,0.3684450524395805
1211,95248,88,60,148,0.5945945945945946,0.40540540540540543
1212,95249,1033,176,1209,0.8544251447477254,0.14557485525227462
1213,95251,167,114,281,0.594306049822064,0.40569395017793597
1214,95252,4712,254,4966,0.9488521949254933,0.05114780507450665
1215,95254,189,8,197,0.9593908629441624,0.04060913705583756
1216,95255,435,356,791,0.549936788874842,0.450063211125158
1217,95257,110,150,260,0.4230769230769231,0.5769230769230769
1218,95258,1240,1,1241,0.9991941982272361,0.0008058017727639
1219,95301,8904,8,8912,0.9991023339317774,0.0008976660682226212
1220,95303,76,1,77,0.987012987012987,0.012987012987012988
1221,95304,3160,3,3163,0.9990515333544103,0.0009484666455896301
1222,95305,34,14,48,0.7083333333333334,0.2916666666666667
1223,95306,275,55,330,0.8333333333333334,0.16666666666666666
1224,95307,9625,8,9633,0.9991695214367279,0.0008304785632720855
1225,95310,442,257,699,0.6323319027181689,0.3676680972818312
1226,95311,470,322,792,0.5934343434343434,0.4065656565656566
1228,95313,154,1,155,0.9935483870967742,0.0064516129032258064
1229,95315,2641,0,2641,1.0,0.0
1230,95316,1690,0,1690,1.0,0.0
1232,95318,43,38,81,0.5308641975308642,0.4691358024691358
1233,95319,329,0,329,1.0,0.0
1234,95320,3069,5,3074,0.998373454782043,0.0016265452179570592
1235,95321,1600,1542,3142,0.5092297899427116,0.4907702100572883
1236,95322,2400,1,2401,0.9995835068721366,0.00041649312786339027
1237,95323,203,2,205,0.9902439024390244,0.00975609756097561
1238,95324,1671,1,1672,0.9994019138755981,0.0005980861244019139
1240,95326,2359,2,2361,0.9991529013130029,0.0008470986869970351
1241,95327,1538,339,1877,0.8193926478423016,0.18060735215769846
1242,95328,1020,0,1020,1.0,0.0
1243,95329,936,177,1113,0.8409703504043127,0.15902964959568733
1244,95330,8379,2,8381,0.9997613649922443,0.00023863500775563775
1245,95333,477,1,478,0.997907949790795,0.0020920502092050207
1246,95334,3323,5,3328,0.9984975961538461,0.0015024038461538462
1247,95335,519,559,1078,0.48144712430426717,0.5185528756957328
1248,95336,13214,4,13218,0.9996973823573915,0.0003026176426085641
1249,95337,11750,9,11759,0.9992346287949656,0.0007653712050344417
1250,95338,2823,1296,4119,0.685360524399126,0.314639475600874
1251,95340,10456,6,10462,0.9994264958898872,0.0005735041101127892
1252,95341,5871,7,5878,0.9988091187478735,0.0011908812521265737
1253,95345,106,104,210,0.5047619047619047,0.49523809523809526
1254,95346,515,668,1183,0.4353338968723584,0.5646661031276415
1255,95348,7947,5,7952,0.9993712273641852,0.0006287726358148893
1256,95350,13890,5,13895,0.9996401583303347,0.0003598416696653472
1257,95351,9394,7,9401,0.9992553983618764,0.0007446016381236039
1258,95354,6780,8,6788,0.9988214496169712,0.0011785503830288745
1259,95355,16437,8,16445,0.9995135299483126,0.000486470051687443
1260,95356,8600,1,8601,0.9998837344494826,0.0001162655505173817
1261,95357,3135,6,3141,0.9980897803247374,0.0019102196752626551
1262,95358,6507,10,6517,0.9984655516341875,0.0015344483658124904
1263,95360,3211,2,3213,0.9993775287892935,0.0006224712107065049
1264,95361,9218,17,9235,0.9981591770438549,0.0018408229561451001
1265,95363,7076,7,7083,0.9990117181985034,0.000988281801496541
1266,95364,356,120,476,0.7478991596638656,0.25210084033613445
1267,95365,853,5,858,0.9941724941724942,0.005827505827505828
1268,95366,4912,1,4913,0.9997964583757378,0.0002035416242621616
1269,95367,6553,0,6553,1.0,0.0
1270,95368,3895,0,3895,1.0,0.0
1271,95369,187,3,190,0.9842105263157894,0.015789473684210527
1272,95370,6654,3314,9968,0.6675361155698234,0.33246388443017655
1273,95372,487,260,747,0.6519410977242303,0.34805890227576974
1274,95374,235,0,235,1.0,0.0
1275,95375,256,215,471,0.5435244161358811,0.4564755838641189
1276,95376,13375,3,13378,0.9997757512333683,0.00022424876663178353
1277,95377,10122,11,10133,0.9989144379749334,0.0010855620250666141
1278,95379,922,428,1350,0.682962962962963,0.31703703703703706
1279,95380,8762,3,8765,0.9996577296063891,0.00034227039361095263
1280,95382,9682,5,9687,0.9994838443274492,0.0005161556725508413
1281,95383,1546,1756,3302,0.46820109024833434,0.5317989097516657
1283,95386,2381,2,2383,0.9991607217792698,0.000839278220730172
1284,95387,33,0,33,1.0,0.0
1285,95388,3175,2,3177,0.9993704752911552,0.0006295247088448222
1286,95389,188,258,446,0.42152466367713004,0.57847533632287
1287,95391,6881,0,6881,1.0,0.0
1288,95401,8993,5,8998,0.9994443209602134,0.0005556790397866192
1289,95403,10786,53,10839,0.9951102500230649,0.004889749976935142
1290,95404,11277,291,11568,0.9748443983402489,0.025155601659751038
1291,95405,6550,6,6556,0.99908480780964,0.0009151921903599756
1292,95407,7955,24,7979,0.9969921042737185,0.003007895726281489
1293,95409,8876,46,8922,0.9948442053351266,0.0051557946648733465
1294,95410,395,35,430,0.9186046511627907,0.08139534883720931
1295,95412,74,15,89,0.8314606741573034,0.16853932584269662
1296,95415,359,32,391,0.9181585677749361,0.08184143222506395
1297,95417,45,5,50,0.9,0.1
1298,95420,122,11,133,0.9172932330827067,0.08270676691729323
1299,95421,738,100,838,0.8806682577565632,0.11933174224343675
1300,95422,4637,187,4824,0.9612354892205639,0.03876451077943615
1301,95423,1884,85,1969,0.9568308786185881,0.043169121381411886
1302,95425,3377,101,3478,0.9709603220241518,0.02903967797584819
1303,95426,521,173,694,0.7507204610951008,0.24927953890489912
1304,95427,206,12,218,0.944954128440367,0.05504587155963303
1305,95428,318,36,354,0.8983050847457628,0.1016949152542373
1306,95429,16,17,33,0.48484848484848486,0.5151515151515151
1307,95430,54,6,60,0.9,0.1
1308,95432,149,20,169,0.8816568047337278,0.11834319526627218
1310,95436,2240,118,2358,0.9499575911789653,0.05004240882103478
1311,95437,4993,82,5075,0.9838423645320197,0.016157635467980297
1312,95439,170,0,170,1.0,0.0
1313,95441,486,69,555,0.8756756756756757,0.12432432432432433
1314,95442,1245,95,1340,0.9291044776119403,0.0708955223880597
1315,95443,116,13,129,0.8992248062015504,0.10077519379844961
1316,95444,265,0,265,1.0,0.0
1317,95445,1074,134,1208,0.8890728476821192,0.11092715231788079
1318,95446,2625,226,2851,0.9207295685724307,0.07927043142756927
1319,95448,5375,313,5688,0.944971870604782,0.055028129395218006
1320,95449,310,23,333,0.9309309309309309,0.06906906906906907
1321,95450,250,75,325,0.7692307692307693,0.23076923076923078
1322,95451,3817,746,4563,0.836511067280298,0.16348893271970194
1323,95452,644,20,664,0.9698795180722891,0.030120481927710843
1324,95453,3809,78,3887,0.979933110367893,0.020066889632107024
1325,95454,477,126,603,0.7910447761194029,0.208955223880597
1326,95456,380,38,418,0.9090909090909091,0.09090909090909091
1327,95457,1009,209,1218,0.8284072249589491,0.17159277504105092
1328,95458,1180,69,1249,0.944755804643715,0.055244195356285025
1329,95459,280,22,302,0.9271523178807947,0.0728476821192053
1330,95460,1191,42,1233,0.9659367396593674,0.0340632603406326
1331,95461,976,190,1166,0.8370497427101201,0.16295025728987994
1332,95462,835,81,916,0.9115720524017468,0.08842794759825327
1333,95463,63,9,72,0.875,0.125
1334,95464,793,43,836,0.9485645933014354,0.05143540669856459
1335,95465,595,43,638,0.932601880877743,0.06739811912225706
1336,95466,277,30,307,0.9022801302931596,0.09771986970684039
1337,95467,2247,123,2370,0.9481012658227848,0.05189873417721519
1338,95468,345,13,358,0.9636871508379888,0.036312849162011177
1339,95469,451,93,544,0.8290441176470589,0.17095588235294118
1340,95470,1607,81,1688,0.9520142180094787,0.04798578199052133
1341,95471,116,8,124,0.9354838709677419,0.06451612903225806
1342,95472,9555,98,9653,0.9898477157360406,0.01015228426395939
1343,95476,11468,99,11567,0.9914411688423965,0.008558831157603527
1344,95482,7361,221,7582,0.9708520179372198,0.02914798206278027
1345,95485,660,59,719,0.9179415855354659,0.08205841446453407
1346,95486,42,3,45,0.9333333333333333,0.06666666666666667
1347,95488,92,11,103,0.8932038834951457,0.10679611650485436
1348,95490,3463,601,4064,0.8521161417322834,0.14788385826771652
1349,95492,8316,11,8327,0.9986789960369881,0.001321003963011889
1350,95493,56,6,62,0.9032258064516129,0.0967741935483871
1351,95494,103,27,130,0.7923076923076923,0.2076923076923077
1352,95497,1332,69,1401,0.9507494646680942,0.04925053533190578
1353,95501,6244,9,6253,0.9985606908683832,0.001439309131616824
1354,95503,8069,42,8111,0.9948218468746147,0.005178153125385279
1355,95511,32,17,49,0.6530612244897959,0.3469387755102041
1356,95514,20,13,33,0.6060606060606061,0.3939393939393939
1357,95519,5818,24,5842,0.9958918178705922,0.004108182129407737
1358,95521,4853,50,4903,0.9898021619416684,0.010197838058331634
1359,95524,620,9,629,0.985691573926868,0.014308426073131956
1360,95525,518,24,542,0.955719557195572,0.04428044280442804
1361,95526,137,45,182,0.7527472527472527,0.24725274725274726
1362,95527,112,57,169,0.6627218934911243,0.33727810650887574
1363,95528,339,22,361,0.9390581717451524,0.060941828254847646
1364,95531,5884,48,5932,0.9919082939986514,0.008091706001348618
1365,95536,752,16,768,0.9791666666666666,0.020833333333333332
1366,95537,77,0,77,1.0,0.0
1367,95540,4099,23,4122,0.9944201843765162,0.005579815623483746
1368,95542,482,197,679,0.7098674521354934,0.29013254786450665
1369,95543,257,84,341,0.7536656891495601,0.24633431085043989
1371,95546,173,14,187,0.9251336898395722,0.0748663101604278
1372,95547,390,1,391,0.9974424552429667,0.0025575447570332483
1373,95548,232,8,240,0.9666666666666667,0.03333333333333333
1374,95549,277,25,302,0.9172185430463576,0.08278145695364239
1375,95550,12,24,36,0.3333333333333333,0.6666666666666666
1376,95551,404,4,408,0.9901960784313726,0.00980392156862745
1377,95552,104,43,147,0.7074829931972789,0.2925170068027211
1378,95553,139,58,197,0.7055837563451777,0.29441624365482233
1379,95554,83,29,112,0.7410714285714286,0.25892857142857145
1380,95555,82,7,89,0.9213483146067416,0.07865168539325842
1381,95556,65,35,100,0.65,0.35
1382,95558,96,30,126,0.7619047619047619,0.23809523809523808
1383,95559,26,11,37,0.7027027027027027,0.2972972972972973
1384,95560,396,115,511,0.7749510763209393,0.22504892367906065
1385,95562,1057,5,1062,0.995291902071563,0.004708097928436911
1386,95563,188,117,305,0.6163934426229508,0.3836065573770492
1387,95564,75,0,75,1.0,0.0
1388,95565,165,4,169,0.9763313609467456,0.023668639053254437
1389,95567,649,3,652,0.995398773006135,0.004601226993865031
1391,95569,43,8,51,0.8431372549019608,0.1568627450980392
1392,95570,1021,21,1042,0.9798464491362764,0.02015355086372361
1393,95571,66,4,70,0.9428571428571428,0.05714285714285714
1394,95573,585,121,706,0.8286118980169972,0.17138810198300283
1395,95585,62,7,69,0.8985507246376812,0.10144927536231885
1396,95587,36,10,46,0.782608695652174,0.21739130434782608
1397,95589,572,76,648,0.8827160493827161,0.11728395061728394
1398,95595,19,14,33,0.5757575757575758,0.42424242424242425
1399,95601,86,14,100,0.86,0.14
1400,95602,4561,1619,6180,0.7380258899676375,0.2619741100323625
1401,95603,8389,688,9077,0.9242040321692189,0.07579596783078109
1402,95605,2913,0,2913,1.0,0.0
1403,95606,35,4,39,0.8974358974358975,0.10256410256410256
1404,95607,66,2,68,0.9705882352941176,0.029411764705882353
1405,95608,16274,6,16280,0.9996314496314497,0.00036855036855036854
1406,95610,10802,4,10806,0.9996298352766981,0.00037016472330186933
1407,95612,231,0,231,1.0,0.0
1408,95614,1209,420,1629,0.7421731123388582,0.2578268876611418
1409,95615,118,0,118,1.0,0.0
1410,95616,8492,5,8497,0.9994115570201247,0.0005884429798752501
1411,95618,6226,0,6226,1.0,0.0
1412,95619,1376,149,1525,0.9022950819672131,0.09770491803278689
1413,95620,5798,1,5799,0.9998275564752543,0.0001724435247456458
1414,95621,11801,3,11804,0.9997458488647916,0.0002541511352084039
1415,95623,1259,285,1544,0.8154145077720207,0.18458549222797926
1416,95624,18857,2,18859,0.9998939498382735,0.00010605016172649663
1417,95625,53,0,53,1.0,0.0
1418,95626,1778,1,1779,0.9994378864530635,0.0005621135469364812
1419,95627,908,0,908,1.0,0.0
1420,95628,13592,8,13600,0.9994117647058823,0.000588235294117647
1421,95629,273,153,426,0.6408450704225352,0.3591549295774648
1422,95630,26988,6,26994,0.9997777283840854,0.0002222716159146477
1423,95631,833,1468,2301,0.36201651455888745,0.6379834854411126
1424,95632,8459,4,8463,0.999527354366064,0.0004726456339359565
1425,95633,631,546,1177,0.536108751062022,0.4638912489379779
1426,95634,672,494,1166,0.5763293310463122,0.4236706689536878
1427,95635,202,223,425,0.4752941176470588,0.5247058823529411
1428,95636,200,121,321,0.6230529595015576,0.37694704049844235
1429,95637,90,5,95,0.9473684210526315,0.05263157894736842
1430,95638,577,5,582,0.9914089347079038,0.00859106529209622
1431,95639,56,0,56,1.0,0.0
1432,95640,3171,52,3223,0.9838659633881477,0.016134036611852313
1433,95641,586,5,591,0.9915397631133672,0.008460236886632826
1434,95642,2337,265,2602,0.8981552651806303,0.10184473481936972
1435,95645,304,1,305,0.9967213114754099,0.003278688524590164
1436,95646,195,47,242,0.8057851239669421,0.19421487603305784
1437,95648,20328,47,20375,0.9976932515337423,0.0023067484662576687
1438,95650,4346,152,4498,0.9662072032014228,0.03379279679857715
1439,95651,200,65,265,0.7547169811320755,0.24528301886792453
1441,95653,81,0,81,1.0,0.0
1442,95655,1267,0,1267,1.0,0.0
1443,95658,2386,129,2515,0.9487077534791253,0.05129224652087475
1444,95659,134,2,136,0.9852941176470589,0.014705882352941176
1445,95660,7673,4,7677,0.9994789631366419,0.0005210368633580826
1446,95661,9088,2,9090,0.9997799779977998,0.00022002200220022002
1447,95662,10227,2,10229,0.999804477466028,0.00019552253397204028
1448,95663,909,17,926,0.9816414686825053,0.0183585313174946
1449,95664,256,220,476,0.5378151260504201,0.46218487394957986
1450,95665,1005,863,1868,0.5380085653104925,0.4619914346895075
1451,95666,1548,1695,3243,0.47733580018501387,0.5226641998149861
1452,95667,8168,4316,12484,0.6542774751682153,0.34572252483178467
1453,95668,146,0,146,1.0,0.0
1454,95669,779,55,834,0.934052757793765,0.06594724220623502
1455,95670,14043,2,14045,0.9998576005695977,0.00014239943040227838
1456,95672,1220,337,1557,0.783558124598587,0.21644187540141296
1457,95673,4417,10,4427,0.9977411339507567,0.00225886604924328
1458,95674,160,1,161,0.9937888198757764,0.006211180124223602
1459,95675,43,78,121,0.35537190082644626,0.6446280991735537
1460,95677,8063,3,8066,0.9996280684354079,0.00037193156459211507
1461,95678,11624,1,11625,0.9999139784946236,8.602150537634408e-05
1464,95681,397,3,400,0.9925,0.0075
1465,95682,8028,793,8821,0.9101008955900691,0.08989910440993085
1466,95683,2520,5,2525,0.998019801980198,0.0019801980198019802
1467,95684,780,536,1316,0.5927051671732523,0.4072948328267477
1468,95685,1441,332,1773,0.8127467569091935,0.18725324309080654
1469,95686,168,0,168,1.0,0.0
1470,95687,17806,2,17808,0.9998876909254267,0.00011230907457322552
1471,95688,11343,21,11364,0.9981520591341078,0.0018479408658922914
1472,95689,423,281,704,0.6008522727272727,0.3991477272727273
1473,95690,479,4,483,0.9917184265010351,0.008281573498964804
1474,95691,10657,18,10675,0.9983138173302107,0.0016861826697892272
1475,95692,1331,3,1334,0.9977511244377811,0.0022488755622188904
1476,95693,2207,4,2211,0.9981908638625057,0.0018091361374943465
1477,95694,2547,21,2568,0.991822429906542,0.008177570093457943
1478,95695,8985,4,8989,0.9995550116809434,0.00044498831905662476
1479,95697,57,0,57,1.0,0.0
1480,95698,43,1,44,0.9772727272727273,0.022727272727272728
1481,95699,44,6,50,0.88,0.12
1482,95701,198,212,410,0.48292682926829267,0.5170731707317073
1483,95703,453,264,717,0.6317991631799164,0.3682008368200837
1484,95709,1038,755,1793,0.5789180145008366,0.4210819854991634
1485,95713,1867,1373,3240,0.5762345679012346,0.42376543209876544
1486,95714,116,75,191,0.6073298429319371,0.39267015706806285
1487,95715,51,69,120,0.425,0.575
1488,95717,42,41,83,0.5060240963855421,0.4939759036144578
1489,95720,348,143,491,0.7087576374745418,0.29124236252545826
1490,95721,64,53,117,0.5470085470085471,0.452991452991453
1491,95722,971,937,1908,0.5089098532494759,0.4910901467505241
1492,95724,128,23,151,0.847682119205298,0.152317880794702
1493,95726,1716,2142,3858,0.4447900466562986,0.5552099533437014
1494,95728,823,248,1071,0.7684407096171803,0.2315592903828198
1495,95735,270,101,371,0.7277628032345014,0.2722371967654987
1496,95736,118,11,129,0.9147286821705426,0.08527131782945736
1497,95742,5744,0,5744,1.0,0.0
1498,95746,7470,123,7593,0.9838008692216516,0.01619913077834848
1499,95747,26768,2,26770,0.9999252895031752,7.471049682480388e-05
1500,95757,14816,3,14819,0.9997975571900938,0.0002024428099062015
1501,95758,18119,1,18120,0.9999448123620309,5.518763796909492e-05
1502,95762,18801,277,19078,0.9854806583499318,0.014519341650068142
1503,95765,11548,1,11549,0.9999134124166594,8.658758334054896e-05
1504,95776,6726,0,6726,1.0,0.0
1505,95811,861,11,872,0.9873853211009175,0.01261467889908257
1506,95814,682,9,691,0.9869753979739508,0.013024602026049204
1507,95815,5250,38,5288,0.9928139183055976,0.0071860816944024205
1508,95816,6247,15,6262,0.9976045991695944,0.0023954008304056212
1509,95817,4280,23,4303,0.9946548919358587,0.005345108064141297
1510,95818,6924,26,6950,0.9962589928057554,0.0037410071942446045
1511,95819,6886,3,6889,0.9995645231528524,0.00043547684714762664
1512,95820,10806,28,10834,0.9974155436588518,0.002584456341148237
1513,95821,7887,14,7901,0.9982280723958993,0.0017719276041007468
1514,95822,12909,17,12926,0.9986848212904224,0.0013151787095775956
1515,95823,15388,13,15401,0.9991558989675995,0.0008441010324004935
1516,95824,9157,9,9166,0.9990181104080297,0.000981889591970325
1517,95825,3085,1,3086,0.9996759559300065,0.0003240440699935191
1518,95826,9708,2,9710,0.9997940267765191,0.00020597322348094748
1519,95827,5316,3,5319,0.9994359842075579,0.0005640157924421884
1520,95828,15535,6,15541,0.9996139244578855,0.00038607554211440707
1521,95829,9293,7,9300,0.999247311827957,0.0007526881720430108
1522,95830,248,0,248,1.0,0.0
1523,95831,12401,3,12404,0.9997581425346662,0.0002418574653337633
1524,95832,2527,3,2530,0.9988142292490119,0.0011857707509881424
1525,95833,8538,10,8548,0.9988301357042583,0.001169864295741694
1526,95834,8119,3,8122,0.999630632849052,0.00036936715094804237
1527,95835,11572,0,11572,1.0,0.0
1528,95837,101,0,101,1.0,0.0
1529,95838,9048,43,9091,0.995270047299527,0.0047299527004729955
1530,95841,3706,2,3708,0.9994606256742179,0.0005393743257820927
1531,95842,7320,2,7322,0.9997268505872713,0.0002731494127287626
1532,95843,11878,0,11878,1.0,0.0
1533,95864,8501,0,8501,1.0,0.0
1534,95901,8304,48,8352,0.9942528735632183,0.005747126436781609
1535,95910,17,14,31,0.5483870967741935,0.45161290322580644
1536,95912,1011,3,1014,0.9970414201183432,0.0029585798816568047
1537,95914,212,35,247,0.8582995951417004,0.1417004048582996
1538,95916,184,70,254,0.7244094488188977,0.2755905511811024
1539,95917,828,1,829,0.9987937273823885,0.0012062726176115801
1540,95918,743,67,810,0.917283950617284,0.08271604938271605
1541,95919,209,199,408,0.5122549019607843,0.4877450980392157
1542,95920,31,1,32,0.96875,0.03125
1543,95922,117,81,198,0.5909090909090909,0.4090909090909091
1544,95923,91,46,137,0.6642335766423357,0.3357664233576642
1545,95925,48,39,87,0.5517241379310345,0.4482758620689655
1546,95926,9059,2,9061,0.9997792738108376,0.0002207261891623441
1547,95928,8952,64,9016,0.9929015084294588,0.00709849157054126
1548,95930,71,78,149,0.47651006711409394,0.5234899328859061
1549,95932,1941,5,1946,0.9974306269270298,0.0025693730729701952
1550,95934,80,6,86,0.9302325581395349,0.06976744186046512
1551,95935,187,111,298,0.62751677852349,0.3724832214765101
1552,95936,97,72,169,0.5739644970414202,0.4260355029585799
1553,95937,306,2,308,0.9935064935064936,0.006493506493506494
1554,95938,1032,4,1036,0.9961389961389961,0.003861003861003861
1555,95939,74,8,82,0.9024390243902439,0.0975609756097561
1556,95941,89,67,156,0.5705128205128205,0.42948717948717946
1557,95942,450,331,781,0.5761843790012804,0.4238156209987196
1558,95943,43,0,43,1.0,0.0
1560,95945,6293,2022,8315,0.7568250150330728,0.24317498496692724
1561,95946,3720,617,4337,0.8577357620474982,0.14226423795250173
1562,95947,431,58,489,0.8813905930470347,0.11860940695296524
1563,95948,2605,3,2608,0.9988496932515337,0.0011503067484662577
1564,95949,4739,3184,7923,0.5981320206992301,0.4018679793007699
1565,95950,45,0,45,1.0,0.0
1566,95951,450,0,450,1.0,0.0
1567,95953,2565,8,2573,0.9968907889623008,0.003109211037699184
1568,95954,2289,1052,3341,0.6851242143070937,0.3148757856929063
1569,95955,188,1,189,0.9947089947089947,0.005291005291005291
1570,95956,179,54,233,0.7682403433476395,0.2317596566523605
1571,95957,155,2,157,0.9872611464968153,0.012738853503184714
1572,95959,4486,2866,7352,0.6101741022850925,0.3898258977149075
1573,95960,139,97,236,0.5889830508474576,0.4110169491525424
1574,95961,8101,8,8109,0.9990134418547293,0.000986558145270687
1575,95962,328,170,498,0.6586345381526104,0.3413654618473896
1576,95963,3626,9,3635,0.9975240715268225,0.0024759284731774417
1577,95965,4448,206,4654,0.9557370004297379,0.04426299957026214
1578,95966,8186,1128,9314,0.8788919905518574,0.12110800944814258
1579,95968,407,5,412,0.9878640776699029,0.012135922330097087
1580,95969,3651,385,4036,0.9046085232903865,0.09539147670961348
1581,95970,122,3,125,0.976,0.024
1582,95971,2045,248,2293,0.8918447448757086,0.10815525512429132
1583,95972,41,18,59,0.6949152542372882,0.3050847457627119
1584,95973,10344,89,10433,0.9914693760184031,0.008530623981596857
1585,95974,65,0,65,1.0,0.0
1586,95975,379,243,622,0.6093247588424437,0.39067524115755625
1587,95977,421,160,581,0.7246127366609294,0.27538726333907054
1588,95978,54,34,88,0.6136363636363636,0.38636363636363635
1589,95979,250,9,259,0.9652509652509652,0.03474903474903475
1590,95981,165,94,259,0.637065637065637,0.36293436293436293
1591,95982,1034,1,1035,0.9990338164251208,0.000966183574879227
1592,95983,178,25,203,0.8768472906403941,0.12315270935960591
1593,95984,21,23,44,0.4772727272727273,0.5227272727272727
1594,95986,25,25,50,0.5,0.5
1595,95987,1255,3,1258,0.9976152623211447,0.0023847376788553257
1596,95988,2059,2,2061,0.9990295972828724,0.0009704027171276079
1597,95991,9298,5,9303,0.999462538965925,0.0005374610340750295
1598,95993,9761,1,9762,0.9998975619750051,0.0001024380249948781
1599,96001,11034,144,11178,0.9871175523349437,0.01288244766505636
1600,96002,9745,31,9776,0.996828968903437,0.0031710310965630114
1601,96003,13131,460,13591,0.9661540725480097,0.03384592745199029
1602,96006,165,4,169,0.9763313609467456,0.023668639053254437
1603,96007,6932,147,7079,0.9792343551349061,0.02076564486509394
1604,96008,389,59,448,0.8683035714285714,0.13169642857142858
1605,96009,106,1,107,0.9906542056074766,0.009345794392523364
1606,96010,44,16,60,0.7333333333333333,0.26666666666666666
1608,96013,1326,73,1399,0.947819871336669,0.05218012866333095
1609,96014,63,11,74,0.8513513513513513,0.14864864864864866
1610,96015,55,6,61,0.9016393442622951,0.09836065573770492
1611,96016,180,17,197,0.9137055837563451,0.08629441624365482
1612,96017,91,30,121,0.7520661157024794,0.24793388429752067
1613,96019,3445,102,3547,0.971243304200733,0.028756695799266985
1614,96020,1346,160,1506,0.8937583001328021,0.10624169986719788
1615,96021,3651,54,3705,0.9854251012145749,0.014574898785425101
1616,96022,5137,233,5370,0.9566108007448789,0.043389199255121046
1617,96023,310,6,316,0.9810126582278481,0.0189873417721519
1618,96024,247,103,350,0.7057142857142857,0.29428571428571426
1619,96025,864,173,1037,0.8331726133076182,0.16682738669238187
1620,96027,699,52,751,0.9307589880159787,0.0692410119840213
1621,96028,537,17,554,0.9693140794223827,0.030685920577617327
1624,96032,711,68,779,0.9127086007702182,0.08729139922978177
1625,96033,120,13,133,0.9022556390977443,0.09774436090225563
1626,96034,68,7,75,0.9066666666666666,0.09333333333333334
1627,96035,753,1,754,0.9986737400530504,0.001326259946949602
1628,96037,105,1,106,0.9905660377358491,0.009433962264150943
1629,96038,162,2,164,0.9878048780487805,0.012195121951219513
1630,96039,126,60,186,0.6774193548387096,0.3225806451612903
1631,96040,98,7,105,0.9333333333333333,0.06666666666666667
1632,96041,584,87,671,0.8703427719821163,0.12965722801788376
1633,96044,379,21,400,0.9475,0.0525
1634,96046,56,25,81,0.691358024691358,0.30864197530864196
1635,96047,216,34,250,0.864,0.136
1636,96048,196,36,232,0.8448275862068966,0.15517241379310345
1637,96050,103,32,135,0.762962962962963,0.23703703703703705
1638,96051,520,151,671,0.7749627421758569,0.22503725782414308
1639,96052,465,136,601,0.7737104825291181,0.22628951747088186
1640,96054,60,6,66,0.9090909090909091,0.09090909090909091
1641,96055,1071,2,1073,0.9981360671015843,0.001863932898415657
1642,96056,423,15,438,0.9657534246575342,0.03424657534246575
1643,96057,711,82,793,0.8965952080706179,0.1034047919293821
1644,96058,108,10,118,0.9152542372881356,0.0847457627118644
1645,96059,181,37,218,0.8302752293577982,0.16972477064220184
1646,96061,137,64,201,0.681592039800995,0.31840796019900497
1647,96062,353,24,377,0.9363395225464191,0.0636604774535809
1648,96063,101,49,150,0.6733333333333333,0.32666666666666666
1649,96064,1390,39,1429,0.9727081875437369,0.02729181245626312
1650,96065,144,46,190,0.7578947368421053,0.24210526315789474
1651,96067,3001,105,3106,0.9661944623309723,0.03380553766902769
1653,96069,254,58,312,0.8141025641025641,0.1858974358974359
1654,96071,129,41,170,0.7588235294117647,0.2411764705882353
1655,96073,1574,49,1623,0.9698089956869994,0.030191004313000615
1656,96074,27,5,32,0.84375,0.15625
1657,96075,60,25,85,0.7058823529411765,0.29411764705882354
1658,96076,23,13,36,0.6388888888888888,0.3611111111111111
1659,96080,8287,136,8423,0.9838537338240532,0.016146266175946812
1660,96084,117,16,133,0.8796992481203008,0.12030075187969924
1662,96086,76,24,100,0.76,0.24
1663,96087,210,17,227,0.9251101321585903,0.07488986784140969
1664,96088,1731,409,2140,0.8088785046728972,0.1911214953271028
1665,96090,130,0,130,1.0,0.0
1666,96091,497,163,660,0.753030303030303,0.24696969696969698
1667,96092,67,1,68,0.9852941176470589,0.014705882352941176
1668,96093,1178,59,1237,0.952303961196443,0.047696038803556995
1669,96094,2536,71,2607,0.9727656309934791,0.027234369006520907
1670,96096,212,59,271,0.7822878228782287,0.2177121771217712
1671,96097,2978,77,3055,0.9747954173486089,0.025204582651391163
1672,96101,1678,21,1699,0.9876397881106533,0.012360211889346674
1673,96103,1223,290,1513,0.8083278255122274,0.19167217448777263
1674,96104,221,2,223,0.9910313901345291,0.008968609865470852
1675,96105,161,19,180,0.8944444444444445,0.10555555555555556
1676,96106,246,75,321,0.7663551401869159,0.2336448598130841
1677,96107,275,10,285,0.9649122807017544,0.03508771929824561
1678,96108,71,2,73,0.9726027397260274,0.0273972602739726
1679,96109,247,12,259,0.9536679536679536,0.04633204633204633
1680,96110,34,1,35,0.9714285714285714,0.02857142857142857
1681,96111,43,23,66,0.6515151515151515,0.3484848484848485
1682,96112,46,3,49,0.9387755102040817,0.061224489795918366
1683,96113,207,0,207,1.0,0.0
1684,96114,1006,58,1064,0.9454887218045113,0.05451127819548872
1685,96115,46,0,46,1.0,0.0
1686,96116,47,1,48,0.9791666666666666,0.020833333333333332
1687,96117,82,0,82,1.0,0.0
1688,96118,523,22,545,0.9596330275229358,0.04036697247706422
1690,96120,335,131,466,0.7188841201716738,0.2811158798283262
1691,96121,122,5,127,0.9606299212598425,0.03937007874015748
1692,96122,1425,260,1685,0.8456973293768546,0.1543026706231454
1694,96124,154,49,203,0.7586206896551724,0.2413793103448276
1695,96125,245,107,352,0.6960227272727273,0.3039772727272727
1696,96126,110,13,123,0.8943089430894309,0.10569105691056911
1697,96128,127,1,128,0.9921875,0.0078125
1698,96129,86,4,90,0.9555555555555556,0.044444444444444446
1699,96130,4849,88,4937,0.9821754101681183,0.01782458983188171
1701,96133,59,1,60,0.9833333333333333,0.016666666666666666
1702,96134,404,2,406,0.9950738916256158,0.0049261083743842365
1705,96137,2683,596,3279,0.8182372674595914,0.18176273254040867
1706,96140,1023,371,1394,0.7338593974175036,0.2661406025824964
1707,96141,810,187,997,0.8124373119358074,0.18756268806419257
1708,96142,1290,253,1543,0.8360337005832793,0.16396629941672067
1709,96143,896,375,1271,0.7049567269866247,0.2950432730133753
1710,96145,1803,869,2672,0.6747754491017964,0.32522455089820357
1711,96146,938,532,1470,0.638095238095238,0.3619047619047619
1712,96148,538,217,755,0.7125827814569536,0.28741721854304636
1713,96150,13422,2707,16129,0.8321656643313287,0.16783433566867134
1716,96161,10210,3115,13325,0.7662288930581613,0.23377110694183864
