ZIP Code,new_policies,renewed_policies,nonrenewed_policies,total_units_x,median_home_value,Avg_Median_Income_2018_2021,earned_premium,earned_exposure,expiring_policies,Climate_Disasters_Avf_10yr,New_and_Renewed_to_Nonrenewed_Ratio,New_and_Renewed_to_Total_Units_Ratio,Housing_Affordability_Ratio,Relative_Housing_Cost_Index,Premium_to_Exposure_Ratio,Nonrenewal_Rate,Renewal_Resilience,market_units,fair_plan_units,total_units_y,pct_market,pct_fair_plan,exposure_22
90001,3162,22127,2853,9017,425200.0,45674.5,15005153,34015,24980,0.0,8.864002804065896,2.8045913274925143,9.309352045452057,39629.81563929518,441.13341173011906,0.1142113690952762,0.8857886309047238,6913,2104,9017,0.7666629699456582,0.2333370300543418,532891886
90002,3448,21908,3113,7864,411500.0,40274.75,15336299,31620,25021,0.0,8.14519755862512,3.2243133265513735,10.217319784728645,38808.013970204614,485.0189437065149,0.1244154909875704,0.8755845090124296,6534,1330,7864,0.8308748728382502,0.1691251271617497,391005676
90003,4525,26933,3971,10650,430800.0,41944.25,20549601,40859,30904,0.0,7.921934021657013,2.9538028169014083,10.270776089690482,40473.13875384601,502.9394013558824,0.128494693243593,0.8715053067564069,8716,1934,10650,0.8184037558685446,0.1815962441314554,517188602
90004,2182,15683,2138,5205,1148400.0,51537.75,39605615,40942,17821,0.0,8.355940130963518,3.4322766570605188,22.28269569393309,105842.63679606227,967.3590689267744,0.1199708209415857,0.8800291790584143,4710,495,5205,0.904899135446686,0.0951008645533141,191648836
90005,521,3357,509,1096,964700.0,40237.75,13665743,22208,3866,0.0,7.618860510805501,3.5383211678832116,23.97499860205901,90987.452005901,615.3522604466859,0.1316606311433005,0.8683393688566994,996,100,1096,0.9087591240875912,0.0912408759124087,54169330
90006,1224,6790,1089,3238,716900.0,37731.5,10671112,22738,7879,0.0,7.359044995408632,2.4749845583693637,19.000039754581717,68028.36916351541,469.30741490016715,0.1382155095824343,0.8617844904175657,2402,836,3238,0.7418159357628166,0.2581840642371834,235567228
90007,1143,7147,991,3097,717300.0,29096.0,10749071,31347,8138,0.0,8.365287588294652,2.6767839845011303,24.652873247181745,69787.42523906431,342.9058921108878,0.1217743917424428,0.8782256082575571,2369,728,3097,0.7649338069099129,0.2350661930900872,199358232
90008,2012,17624,1903,5018,781600.0,44970.0,26759003,29933,19527,0.0,10.318444561219128,3.9131127939418096,17.38047587280409,72952.9749918137,893.9632846690943,0.0974548061658216,0.9025451938341784,4774,244,5018,0.9513750498206456,0.0486249501793543,116575448
90011,5015,30290,4442,13585,452100.0,42409.0,24815880,49843,34732,0.0,7.94799639801891,2.598822230401178,10.660473012803886,42430.3222011732,497.88094617097687,0.1278935851664171,0.8721064148335829,10249,3336,13585,0.7544350386455649,0.245564961354435,834345596
90012,296,2660,279,914,633000.0,48121.25,8739469,33407,2939,0.0,10.594982078853048,3.2341356673960613,13.154271761435956,58711.79560801689,261.6059209147783,0.094930248383804,0.905069751616196,827,87,914,0.9048140043763676,0.0951859956236323,25670000
90013,45,327,44,98,664800.0,21864.5,4049561,12904,371,0.0,8.454545454545455,3.795918367346939,30.4054517597018,66529.1011645087,313.82214817110975,0.1185983827493261,0.8814016172506739,98,0,98,1.0,0.0,1714013
90015,217,1379,228,541,715000.0,46177.75,10259786,31702,1607,0.0,7.0,2.9500924214417745,15.48364742760312,66571.98634693526,323.63213677370516,0.1418792781580584,0.8581207218419415,433,108,541,0.800369685767098,0.199630314232902,39756325
90016,3333,24413,3064,7975,677500.0,49753.0,27547927,41956,27477,0.0,9.055483028720626,3.4791222570532914,13.617269310393343,62645.48290944174,656.5908809228716,0.1115114459366015,0.8884885540633984,7218,757,7975,0.905078369905956,0.0949216300940438,236411380
90017,107,493,89,213,697100.0,37126.25,5263437,23994,582,0.0,6.741573033707865,2.816901408450704,18.77647217265412,66251.16232782807,219.36471617904476,0.1529209621993127,0.8470790378006873,192,21,213,0.9014084507042254,0.0985915492957746,7131581
90018,3082,21282,2794,7705,704300.0,48167.75,23537515,35078,24076,0.0,8.720114531138153,3.16210253082414,14.621816464335575,65319.13686746586,671.0050458977137,0.1160491776042531,0.8839508223957468,6469,1236,7705,0.8395846852693056,0.1604153147306943,398532989
90019,3923,27316,3714,9202,1033900.0,57235.75,41664526,51918,31030,0.0,8.411147011308563,3.3948054770702023,18.06388489711413,94377.56555045352,802.506375438191,0.1196906219787302,0.8803093780212697,8223,979,9202,0.8936100847641817,0.1063899152358183,353309012
90020,350,2746,365,804,650300.0,49198.0,18714748,24431,3111,0.0,8.482191780821918,3.850746268656717,13.218016992560674,60192.852691127584,766.0246408251811,0.117325618772099,0.882674381227901,769,35,804,0.9564676616915424,0.0435323383084577,25233833
90022,3482,33260,3212,10929,471000.0,49516.0,18683059,44507,36472,0.0,11.438978829389788,3.361881233415683,9.512076904434933,43570.56172950277,419.7779899791044,0.088067558675148,0.911932441324852,9614,1315,10929,0.879677921127276,0.1203220788727239,347293084
90023,2049,16768,1893,6301,479600.0,44641.0,10755349,26197,18661,0.0,9.940306391970417,2.9863513727979685,10.74348692905625,44795.6027903038,410.55651410466845,0.1014415090295268,0.8985584909704731,4988,1313,6301,0.7916203777178226,0.2083796222821774,325600729
90024,1235,11319,1328,3049,1231000.0,64981.75,62506346,53336,12647,0.0,9.453313253012048,4.117415546080682,18.94378036910363,111082.4181763455,1171.9353907304635,0.1050051395587886,0.8949948604412113,3027,22,3049,0.9927845195145948,0.007215480485405,26971407
90025,1222,10779,1192,2886,905900.0,92294.75,31355528,60486,11971,0.0,10.067953020134228,4.158350658350658,9.815292852518697,79237.33057918392,518.3931488278279,0.0995739704285356,0.9004260295714643,2833,53,2886,0.9816354816354816,0.0183645183645183,23389032
90026,4099,30659,3833,10238,962100.0,65990.0,38903243,61431,34492,0.0,9.068092877641536,3.394999023246728,14.579481739657524,86697.0883383006,633.2835701844346,0.1111272179056013,0.8888727820943987,9124,1114,10238,0.8911896854854464,0.1088103145145536,299533627
90027,2527,19412,2419,5671,1287200.0,70261.25,48118983,49706,21831,0.0,9.069450186027284,3.868629871274907,18.320197833087228,115340.75276446334,968.0719229066914,0.1108057349640419,0.889194265035958,5380,291,5671,0.9486862987127492,0.0513137012872509,227532892
90028,414,2325,402,807,723000.0,48141.0,9146045,32693,2727,0.0,6.813432835820896,3.3940520446096656,15.018383498473234,67056.89212283221,279.755452237482,0.1474147414741474,0.8525852585258525,748,59,807,0.9268897149938042,0.0731102850061957,19396769
90029,1093,7555,1000,2790,898400.0,44346.5,9462226,20402,8555,0.0,8.648,3.099641577060932,20.258644988894275,83964.27204132918,463.7891383197726,0.1168907071887784,0.8831092928112215,2423,367,2790,0.8684587813620072,0.1315412186379928,99631368
90031,1968,17301,1761,5969,616900.0,49304.25,15247290,28255,19062,0.0,10.942078364565589,3.2281789244429553,12.512105954354848,57089.893019726274,539.6315696336932,0.0923827510229776,0.9076172489770225,5094,875,5969,0.8534092812866477,0.1465907187133523,236368301
90032,3240,27438,3063,8159,605400.0,58424.5,22306223,38419,30501,0.0,10.015670910871696,3.7600196102463537,10.362091245967015,55159.26549318186,580.6039459642365,0.1004229369528867,0.8995770630471132,7497,662,8159,0.9188626057114844,0.0811373942885157,204182029
90033,1743,13034,1640,5104,538900.0,41798.5,9936703,21974,14674,0.0,9.010365853658536,2.895180250783699,12.892807158151609,50645.56540124029,452.20273960134705,0.1117623006678479,0.8882376993321521,4107,997,5104,0.8046630094043887,0.1953369905956113,238028522
90034,2165,18900,2143,5181,1152500.0,79068.0,31369570,57385,21043,0.0,9.829678021465236,4.065817409766455,14.576061111954267,102189.52906981688,546.6510412128605,0.1018390913843083,0.8981609086156916,5072,109,5181,0.9789615904265586,0.0210384095734414,44547520
90035,2037,15402,2012,4304,1494600.0,92452.0,32753730,36492,17414,0.0,8.667495029821074,4.051812267657993,16.166226798771255,130710.32455058908,897.5591910555738,0.1155392213161823,0.8844607786838177,4215,89,4304,0.97932156133829,0.02067843866171,43397510
90036,1761,12840,1752,3831,1634700.0,83430.0,38774782,58738,14592,0.0,8.33390410958904,3.8112764291307752,19.593671341244157,144258.22054079716,660.1311246552488,0.1200657894736842,0.8799342105263158,3739,92,3831,0.9759853824066824,0.0240146175933176,63471994
90037,3280,19294,2898,8426,502000.0,38088.25,18246165,32967,22192,0.0,7.789510006901312,2.6790885354854024,13.17991769115147,47593.489641522385,553.4675584675584,0.1305875991348233,0.8694124008651767,6424,2002,8426,0.762402088772846,0.237597911227154,539903171
90038,878,5148,808,1790,945000.0,46745.5,8845120,20622,5956,0.0,7.457920792079208,3.3664804469273744,20.215849653977383,87886.75646726257,428.9166909126176,0.1356615177971793,0.8643384822028207,1628,162,1790,0.9094972067039108,0.0905027932960893,39805291
90039,3118,25960,2920,7624,972900.0,90974.75,32980369,42198,28880,0.0,9.958219178082192,3.8140083945435466,10.694176131289176,85205.0501411777,781.562372624295,0.1011080332409972,0.8988919667590027,7249,375,7624,0.950813221406086,0.0491867785939139,127146068
90040,813,7439,744,2248,452100.0,51291.75,4444889,9644,8183,0.0,11.091397849462366,3.670818505338078,8.814282998727865,41686.317296691646,460.8968270427209,0.0909202004154955,0.9090797995845044,2070,178,2248,0.9208185053380784,0.0791814946619217,53028728
90041,2434,22054,2221,6207,886800.0,88197.5,24519856,30862,24275,0.0,11.025664115263394,3.94522313516997,10.0547067660648,77875.99872167666,794.4999027930788,0.0914933058702368,0.9085066941297631,5955,252,6207,0.9594006766553892,0.0405993233446109,116748568
90043,4315,35756,3958,10520,684500.0,54778.25,39306922,46925,39714,0.0,10.124052551793834,3.8090304182509502,12.49583548214848,62734.57589612394,837.6541715503463,0.0996625875006295,0.9003374124993705,9830,690,10520,0.9344106463878328,0.0655893536121673,269200641
90044,5932,41702,5253,14745,461200.0,38278.5,33137277,59740,46955,0.0,9.067961165048544,3.2305188199389625,12.048538997087135,43704.688120467006,554.6916136591898,0.1118730699606005,0.8881269300393995,12618,2127,14745,0.8557477110885046,0.1442522889114954,599579781
90045,3499,34001,3439,8996,1103500.0,106967.0,40654085,61170,37440,0.0,10.904332654841523,4.168519341929747,10.316265764207651,95291.34132104085,664.6082229851235,0.0918536324786324,0.9081463675213676,8968,28,8996,0.9968875055580256,0.0031124944419742,18919871
90046,3616,20113,3469,6664,1290400.0,72388.0,81206223,75834,23582,0.0,6.840299798212741,3.5607743097238895,17.826159031883737,115319.3517467309,1070.8418783131576,0.1471037231786956,0.8528962768213044,4814,1850,6664,0.7223889555822329,0.2776110444177671,2426873070
90047,5127,41448,4581,12465,519400.0,55327.75,36222636,52469,46029,0.0,10.166994106090373,3.736462093862816,9.387694240232072,47559.61719585193,690.3626141150013,0.0995242129961546,0.9004757870038455,11524,941,12465,0.9245086241476134,0.0754913758523866,316189559
90048,2001,12852,1996,3733,1441200.0,97983.25,33630863,36326,14848,0.0,7.4413827655310625,3.978837396196089,14.70863642510327,125402.95854097538,925.8069426856796,0.1344288793103448,0.8655711206896551,3631,102,3733,0.972676131797482,0.027323868202518,56381293
90049,3512,26250,3596,7541,2000001.0,133344.5,152080914,62092,29846,0.0,8.276418242491657,3.946691420236043,14.998751354574054,169481.68135930167,2449.283546994782,0.1204851571399852,0.8795148428600147,6654,887,7541,0.8823763426601247,0.1176236573398753,1888228709
90056,857,8724,867,2291,1114900.0,92221.75,15758819,12093,9591,0.0,11.050749711649363,4.182016586643387,12.089339011675662,97524.90825963816,1303.1356156454146,0.0903972474194557,0.9096027525805442,2275,16,2291,0.9930161501527716,0.0069838498472282,15599315
90057,277,1477,255,652,576200.0,39276.25,3304352,11264,1732,0.0,6.87843137254902,2.6901840490797544,14.670443334075935,54469.6122260913,293.3551136363636,0.1472286374133949,0.8527713625866051,525,127,652,0.8052147239263804,0.1947852760736196,40607432
90059,3001,19704,2692,6540,415100.0,44838.5,14130817,26845,22396,0.0,8.434249628528974,3.4717125382262997,9.25766919053938,38755.19391080942,526.3854349040789,0.1202000357206644,0.8797999642793356,5742,798,6540,0.8779816513761468,0.1220183486238532,248264383
90061,1787,13541,1655,4532,438800.0,45033.5,10175902,18677,15196,0.0,9.261631419939578,3.382171226831421,9.743857350638969,40951.31763861684,544.8360014991702,0.1089102395367201,0.8910897604632798,3951,581,4532,0.8718005295675199,0.1281994704324801,163146599
90062,2638,17656,2304,6446,550600.0,50859.75,16817252,26476,19960,0.0,8.808159722222221,3.148309028855104,10.8258495175458,50808.22954216059,635.1885481190512,0.1154308617234469,0.8845691382765531,5401,1045,6446,0.8378839590443686,0.1621160409556314,328712352
90063,3508,24843,3148,9014,481100.0,50777.75,16771678,36912,27991,0.0,9.006035578144854,3.145218548923896,9.474622250887446,44401.524527412046,454.3692566103164,0.1124647208031152,0.8875352791968847,7355,1659,9014,0.8159529620590193,0.1840470379409807,437203512
90064,2629,23826,2584,6304,1388300.0,102596.0,43405754,41059,26410,0.0,10.238003095975232,4.196541878172589,13.531716636126164,120318.36684007444,1057.1556540587935,0.097841726618705,0.902158273381295,6257,47,6304,0.9925444162436547,0.0074555837563451,22512477
90065,3799,34204,3593,10087,833400.0,71773.0,36610651,48278,37797,0.0,10.576955190648484,3.767522553782096,11.611608822259068,74535.40376577359,758.3299018186337,0.0950604545334285,0.9049395454665714,9252,835,10087,0.9172201843957568,0.082779815604243,356827197
90066,4177,38888,4104,10320,1282100.0,85389.75,50906303,72254,42992,0.0,10.49342105263158,4.1729651162790695,15.014682675613876,112910.79752372422,704.5465026157722,0.095459620394492,0.904540379605508,10267,53,10320,0.9948643410852712,0.0051356589147286,31185948
90067,62,502,125,133,1344900.0,117175.5,12304883,8478,627,0.0,4.512,4.2406015037593985,11.47765531190394,115230.11491313612,1451.3898325076668,0.1993620414673046,0.8006379585326954,133,0,133,1.0,0.0,728932
90068,3236,19527,3035,6047,1500800.0,87587.75,67398952,42191,22562,0.0,7.500164744645799,3.7643459566727304,17.134816227155053,131875.8981404367,1597.4722571164466,0.1345182164701711,0.865481783529829,4931,1116,6047,0.8154456755415909,0.1845543244584091,1417786378
90069,1617,9423,1653,2790,890100.0,93829.5,61007272,44465,11076,0.0,6.678765880217786,3.956989247311828,9.486355570476237,77743.18828319573,1372.0290565613404,0.1492416034669555,0.8507583965330444,2548,242,2790,0.9132616487455196,0.0867383512544802,415182620
90077,1579,9655,1608,3113,2000001.0,210992.75,85832061,16459,11263,0.0,6.986318407960199,3.60873755220045,9.47900342547315,163137.8199503681,5214.901330579015,0.1427683565657462,0.8572316434342537,1680,1433,3113,0.5396723417924831,0.4603276582075168,2531735350
90094,354,1759,300,499,1132000.0,159760.75,9995792,23015,2059,0.0,7.043333333333333,4.234468937875752,7.08559517904116,94479.51942605311,434.3164023462959,0.1457017969888295,0.8542982030111704,499,0,499,1.0,0.0,427050
90201,3648,40337,3398,12576,440500.0,45491.0,19681602,54035,43735,2.125,12.94437904649794,3.4975349872773536,9.68323404629487,41071.22794160296,364.23803090589433,0.0776952097862124,0.9223047902137876,11460,1116,12576,0.9112595419847328,0.0887404580152671,283630711
90210,3183,20296,3398,6267,2000001.0,149397.25,219900045,34687,23694,0.0,6.909652736904061,3.746449656933142,13.387133966656013,167864.68633450472,6339.552137688471,0.1434118342196336,0.8565881657803663,4464,1803,6267,0.7123025370990905,0.2876974629009095,3745871198
90211,648,4462,646,1304,2000001.0,88676.5,12879555,11231,5108,0.0,7.910216718266254,3.918711656441718,22.553900977147272,175550.32505165096,1146.786127682308,0.1264682850430697,0.8735317149569303,1269,35,1304,0.973159509202454,0.026840490797546,29049584
90212,584,4999,580,1344,2000001.0,91771.25,20121653,14941,5579,0.0,9.625862068965516,4.154017857142857,21.79332852064236,175023.3209114335,1346.7407134729938,0.103961283384119,0.896038716615881,1316,28,1344,0.9791666666666666,0.0208333333333333,28549525
90220,4094,31345,3806,9512,394900.0,59419.5,24450768,41243,35151,2.125,9.311350499211771,3.7257148864592096,6.645966391504473,35924.89355306273,592.8464951628155,0.1082757247304486,0.8917242752695513,8811,701,9512,0.9263036164844408,0.0736963835155593,213310049
90221,3144,26648,2759,8325,412600.0,52858.0,19010197,34554,29407,2.125,10.798115259151867,3.578618618618618,7.805819365091377,37938.95879335824,550.1590843317706,0.0938211990342435,0.9061788009657564,7454,871,8325,0.8953753753753754,0.1046246246246246,273156086
90222,2373,17355,2152,5427,420700.0,54131.75,12300753,23110,19507,2.125,9.16728624535316,3.6351575456053062,7.771779039103668,38599.24763878438,532.2697100822155,0.1103193725329368,0.8896806274670631,4816,611,5427,0.8874147779620416,0.1125852220379583,182708008
90230,1940,19662,1905,5233,849200.0,87626.75,28798215,44377,21567,0.0,11.339632545931758,4.12803363271546,9.691104599908131,74616.62592051244,648.9446109471122,0.0883293921268604,0.9116706078731396,5189,44,5233,0.991591821135104,0.0084081788648958,24989090
90232,1253,12297,1211,3378,1219100.0,94169.75,15243525,22964,13508,0.0,11.189099917423617,4.01124925991711,12.945770802194971,106445.08083300672,663.8009493119665,0.0896505774355937,0.9103494225644064,3336,42,3378,0.9875666074600356,0.0124333925399644,15289463
90240,2393,20988,2260,5566,646900.0,86932.5,19905031,27134,23248,2.125,10.345575221238938,4.200682716492993,7.441405688321399,56880.89459302237,733.5826269624825,0.0972126634549208,0.9027873365450793,5457,109,5566,0.9804168163851958,0.0195831836148041,61406225
90241,2832,27352,2700,7325,627700.0,72352.0,24360167,40779,30052,2.125,11.17925925925926,4.120682593856655,8.67564130915524,56098.24485493188,597.3703867186542,0.0898442699321176,0.9101557300678824,7201,124,7325,0.9830716723549487,0.0169283276450511,64556262
90242,2659,27186,2535,7322,557700.0,71323.5,19810541,38713,29721,2.125,11.773175542406312,4.076072111444961,7.819302193526678,49906.12447084513,511.72838581355103,0.0852932270112042,0.9147067729887958,7163,159,7322,0.9782846216880634,0.0217153783119366,69708416
90245,1171,12731,1115,3363,1244200.0,112729.75,16124005,24070,13846,0.0,12.468161434977578,4.133809099018733,11.03701551719932,106956.66505545644,669.8797257997508,0.080528672540806,0.919471327459194,3359,4,3363,0.9988105857865002,0.0011894142134998,2038250
90247,2489,25252,2411,7799,540800.0,58444.75,21659291,39909,27663,2.125,11.506014102032353,3.556994486472625,9.25318356225324,49271.86810248929,542.7169560750708,0.0871561291255467,0.9128438708744532,7575,224,7799,0.9712783690216694,0.0287216309783305,72133990
90248,859,8946,866,2372,571200.0,64223.0,7427865,11824,9812,2.125,11.32217090069284,4.133642495784148,8.894009934135745,51598.3721275345,628.2023849797023,0.088259274357929,0.911740725642071,2326,46,2372,0.9806070826306914,0.0193929173693086,18091131
90249,1972,20539,1913,5473,584000.0,63878.5,16262743,26577,22452,2.125,11.767381076842655,4.113100676046044,9.142356191832931,52780.28215748407,611.9104112578545,0.0852039907357919,0.914796009264208,5396,77,5473,0.9859309336744017,0.0140690663255983,30983794
90250,4663,47124,4391,13245,661400.0,58926.0,38644035,73731,51515,2.125,11.793896606695514,3.909928274820687,11.22424736109697,60214.65131143866,524.1219432803027,0.0852373095214985,0.9147626904785016,12867,378,13245,0.9714609286523216,0.0285390713476783,111099896
90254,1933,19849,1878,5197,1674500.0,140194.5,32122858,37520,21727,0.0,11.598509052183172,4.1912641908793535,11.94412048974817,141298.64438782173,856.1529317697228,0.0864362314171307,0.9135637685828693,5181,16,5197,0.996921300750433,0.003078699249567,4622877
90255,2855,29554,2621,9668,455000.0,47709.5,17278183,40311,32175,0.0,12.365127813811522,3.3521928009929667,9.536884687536023,42235.66532375407,428.62203864950015,0.0814607614607614,0.9185392385392386,8518,1150,9668,0.8810508895324782,0.1189491104675217,344265759
90260,2323,23831,2238,6623,597300.0,68503.0,16264306,33771,26069,2.125,11.68632707774799,3.9489657255020383,8.719326160898063,53643.43932253504,481.6056971958189,0.0858490927922053,0.9141509072077948,6475,148,6623,0.9776536312849162,0.0223463687150838,46079594
90262,3137,31719,3046,9565,449600.0,55322.75,18679859,40668,34765,2.125,11.443204202232437,3.644119184526921,8.12685558834295,41168.619255953156,459.325735221796,0.0876168560333668,0.9123831439666332,8712,853,9565,0.9108207004704651,0.0891792995295347,281460380
90266,4242,42425,4314,10876,2000001.0,156654.5,79917999,59648,46739,0.0,10.81757070004636,4.2908238322912835,12.76695530610356,167199.02779248235,1339.8269682135194,0.0922997924645371,0.9077002075354628,10842,34,10876,0.9968738506803972,0.0031261493196027,28544099
90270,1063,11772,987,3800,481800.0,47377.75,5869066,15023,12759,2.125,13.00405268490375,3.3776315789473683,10.169330540179724,44752.379504670826,390.67203621114294,0.0773571596520103,0.9226428403479896,3381,419,3800,0.8897368421052632,0.1102631578947368,114175618
90272,3190,25881,3264,7191,2000001.0,199591.0,117553058,38730,29145,0.0,8.90655637254902,4.0426922542066475,10.020496916193617,163880.43367604562,3035.193854892848,0.1119917653113741,0.8880082346886259,6613,578,7191,0.9196217494089834,0.0803782505910165,1101997923
90274,3442,31981,3408,8308,1757700.0,175000.5,75162413,41284,35389,0.0,10.394072769953052,4.263721714010592,10.043971302939134,145594.82938957194,1820.6184720472825,0.0963011105145666,0.9036988894854332,8263,45,8308,0.9945835339431872,0.0054164660568127,77538324
90275,4909,47105,4825,12219,1247000.0,144054.25,76151620,66203,51930,0.0,10.780103626943005,4.2568131598330465,8.656461020761276,104984.4880080661,1150.274458861381,0.0929135374542653,0.9070864625457348,12158,61,12219,0.9950077747769868,0.0049922252230133,73495568
90277,2688,27063,2552,6881,1143800.0,106296.0,41825846,60450,29615,0.0,11.657915360501567,4.323644819066996,10.760517799352751,98825.09819615778,691.9081224152192,0.0861725476954246,0.9138274523045754,6847,34,6881,0.995058857724168,0.004941142275832,14795220
90278,3345,34529,3321,8439,992600.0,123560.25,41360387,60690,37850,0.0,11.404396266184884,4.487972508591065,8.033327870411398,84660.44096942998,681.5025045312243,0.0877410832232496,0.9122589167767504,8408,31,8439,0.996326578978552,0.003673421021448,14895522
90280,4879,51597,4595,15568,470200.0,54341.0,29406466,65240,56192,0.0,12.29075081610446,3.6276978417266186,8.652766787508511,43125.609595395246,450.7428877988964,0.0817732061503416,0.9182267938496584,14367,1201,15568,0.92285457348407,0.0771454265159301,369124223
90290,1085,4552,955,2353,1184900.0,128175.25,22606370,12508,5507,2.125,5.90261780104712,2.395665108372291,9.24437440145426,100746.91866784958,1807.3528941477457,0.1734156528055202,0.8265843471944797,561,1792,2353,0.2384190395240119,0.7615809604759881,2116336922
90291,3152,24905,3187,6970,1899800.0,99199.5,40475460,47144,28092,2.125,8.803577031691246,4.025394548063128,19.151306206180475,165129.8090196488,858.5495503139318,0.1134486686601167,0.8865513313398833,6821,149,6970,0.978622668579627,0.021377331420373,52070749
90292,723,5218,762,1427,1076900.0,120707.0,31440039,56119,5980,0.0,7.796587926509186,4.163279607568325,8.921603552403754,92033.91394265438,560.2387604910992,0.1274247491638796,0.8725752508361204,1415,12,1427,0.9915907498248072,0.0084092501751927,9830999
90293,775,6287,783,1643,899000.0,106359.25,16699291,24852,7070,0.0,9.019157088122606,4.298234936092514,8.452485326852154,77670.21968445873,671.9495815226139,0.1107496463932107,0.8892503536067893,1636,7,1643,0.995739500912964,0.0042604990870359,4136867
90301,1412,13560,1202,4341,547900.0,49552.0,11279681,24149,14762,2.125,12.455906821963394,3.448974890578208,11.057071359380044,50680.90427496841,467.086877303408,0.0814252811272185,0.9185747188727814,4038,303,4341,0.930200414651002,0.0697995853489979,89385816
90302,1259,12230,1233,3617,590000.0,54234.75,12386974,23741,13463,2.125,10.93998377939984,3.7293337019629527,10.878634086079495,54123.09198313297,521.7545175013689,0.0915843422714105,0.9084156577285896,3370,247,3617,0.9317113630080176,0.0682886369919823,76743342
90303,1457,15271,1379,4554,606100.0,58559.5,11997859,18986,16650,2.125,12.13052936910805,3.673254281949934,10.350156678250327,55211.433686596014,631.9318971874012,0.0828228228228228,0.9171771771771772,4301,253,4554,0.9444444444444444,0.0555555555555555,74266532
90304,1115,11832,998,3739,586600.0,47839.5,7826240,16408,12830,2.125,12.972945891783567,3.4626905589729873,12.261833840236624,54437.768881701755,476.977084349098,0.0777864380358534,0.9222135619641464,3408,331,3739,0.9114736560577694,0.0885263439422305,91976917
90305,1339,13191,1313,3628,646500.0,80841.25,15867434,19687,14504,2.125,11.066260472201066,4.004961411245866,7.997154917817327,57211.160940254216,805.9853710570427,0.0905267512410369,0.9094732487589632,3522,106,3628,0.9707828004410144,0.0292171995589856,54970411
90402,1330,12903,1416,3394,2000001.0,146775.75,57019539,20939,14319,0.0,10.051553672316384,4.193576900412492,13.626235941563916,168114.4791741893,2723.12617603515,0.0988895872616802,0.9011104127383196,3368,26,3394,0.9923394225103124,0.0076605774896876,38660984
90403,670,6659,679,1740,1523400.0,109892.5,24265616,38683,7338,0.0,10.793814432989691,4.212068965517242,13.862638487612896,131245.46847197865,627.2940568208256,0.0925320250749523,0.9074679749250476,1710,30,1740,0.9827586206896552,0.0172413793103448,21992745
90404,537,5760,577,1576,922900.0,75991.0,11743771,25682,6337,0.0,10.913344887348352,3.9955583756345177,12.144859259649168,82120.44845456076,457.2763414064325,0.0910525485245384,0.9089474514754616,1527,49,1576,0.9689086294416244,0.0310913705583756,12657844
90405,1622,17234,1672,4600,1430800.0,95870.5,31862487,43043,18906,0.0,11.277511961722489,4.099130434782609,14.924298924069449,124734.61201526674,740.2478219454964,0.0884375330582883,0.9115624669417116,4519,81,4600,0.982391304347826,0.0176086956521739,25465805
90501,2749,28066,2597,7571,724900.0,74646.75,26138520,44240,30663,2.125,11.86561417019638,4.070136045436534,9.711072484736444,64604.83592887996,590.8345388788426,0.0846949091739229,0.915305090826077,7456,115,7571,0.9848104609694888,0.0151895390305111,34557549
90502,1292,11729,1217,3143,520700.0,79592.75,11121831,22106,12946,2.125,10.699260476581758,4.142857142857143,6.542053139262056,46142.210415233414,503.1136795440152,0.0940058705391626,0.9059941294608372,3101,42,3143,0.9866369710467706,0.0133630289532293,13534494
90503,2629,31562,2585,8097,861000.0,96498.75,34477451,56631,34147,2.125,13.226692456479691,4.222675064838829,8.922395367815644,75017.73938291411,608.8087973018312,0.075702111459279,0.924297888540721,8079,18,8097,0.9977769544275658,0.0022230455724342,11642126
90504,2438,29698,2465,7628,712300.0,91674.5,25660349,39580,32163,2.125,13.036916835699795,4.212899842684846,7.769881482855101,62340.27907812531,648.316043456291,0.076640860616236,0.923359139383764,7610,18,7628,0.9976402726796014,0.0023597273203985,8313069
90505,2900,32336,2912,8337,916100.0,98186.75,36129378,50276,35248,2.125,12.100274725274724,4.2264603574427255,9.33017947941041,79698.10898121023,718.6207733312117,0.082614616432138,0.917385383567862,8317,20,8337,0.9976010555355644,0.0023989444644356,15556414
90601,2860,26659,2750,7198,626500.0,78368.25,28959670,37671,29409,2.125,10.73418181818182,4.1010002778549595,7.994308919747474,55594.13597399797,768.7523559236548,0.0935087898262436,0.9064912101737564,6934,264,7198,0.963323145318144,0.036676854681856,160340744
90602,1898,15412,1696,4370,601600.0,54133.25,14388871,22459,17108,2.125,10.2063679245283,3.961098398169336,11.113317600550491,55196.692042752555,640.6728260385592,0.0991349076455459,0.900865092354454,4221,149,4370,0.9659038901601832,0.0340961098398169,85496759
90603,2007,21892,1982,5696,649600.0,103807.25,21628016,27259,23874,2.125,12.058022199798184,4.195751404494382,6.25775174662656,56241.006807720194,793.4266113944019,0.0830191840495937,0.9169808159504064,5656,40,5696,0.9929775280898876,0.0070224719101123,25741079
90604,3454,32491,3243,8524,591400.0,78015.25,26485250,41871,35734,2.125,11.083872957138452,4.216916940403566,7.580569183589106,52500.47680379441,632.5440042033866,0.0907539038450775,0.9092460961549224,8428,96,8524,0.988737681839512,0.011262318160488,43727731
90605,3357,32570,3275,8654,556000.0,78755.25,27719932,40587,35845,2.125,10.970076335877865,4.151490640166397,7.059846803863869,49316.57419168771,682.9756325917166,0.0913656018970567,0.9086343981029432,8419,235,8654,0.9728449272012942,0.0271550727987058,127109017
90606,2652,25488,2574,6861,509600.0,75680.0,17765235,31181,28062,2.125,10.932400932400933,4.10144293834718,6.733615221987315,45361.20603474546,569.7455181039736,0.0917254650416933,0.9082745349583066,6653,208,6861,0.969683719574406,0.0303162804255939,85938869
90620,4494,41279,4374,10846,622700.0,95911.5,34746655,53097,45653,0.0,10.464791952446271,4.220265535681357,6.492443554735355,54283.86063802216,654.3995894306646,0.095809694872188,0.904190305127812,10826,20,10846,0.9981560022127972,0.0018439977872026,9419550
90621,2037,14248,1945,3882,643200.0,69137.5,17066074,31399,16193,0.0,8.372750642673521,4.195002575991757,9.303200144639304,57717.92087751948,543.5228510462117,0.1201136293460137,0.8798863706539863,3863,19,3882,0.99510561566203,0.0048943843379701,11830960
90623,1280,14233,1297,3708,739200.0,105161.0,15183609,19106,15530,0.0,11.960678488820356,4.183656957928803,7.0292218598149505,63926.67644462256,794.7037056422066,0.0835157759175788,0.9164842240824213,3701,7,3708,0.9981121898597628,0.0018878101402373,3636120
90630,4156,40645,4101,10714,700100.0,99142.5,44316791,64772,44746,0.0,10.92440868080956,4.181538174351316,7.061552815391987,60855.434852576065,684.1967362440561,0.0916506503374603,0.9083493496625396,10692,22,10714,0.997946611909651,0.002053388090349,11758883
90631,5991,50103,6024,13273,628900.0,85786.75,58491355,78018,56127,0.0,9.31175298804781,4.226173434792436,7.330968943339152,55362.76817365488,749.7161552462252,0.1073280239456945,0.8926719760543054,12999,274,13273,0.9793565885632488,0.0206434114367513,263594104
90638,4842,45794,4629,11934,630100.0,93374.5,42191620,59951,50423,0.0,10.938863685461223,4.2430031841796545,6.748095036653476,55057.62253166035,703.7684108688762,0.0918033437121948,0.9081966562878052,11870,64,11934,0.9946371711077592,0.0053628288922406,33566972
90640,3556,37050,3426,10299,558600.0,59651.25,30822962,52917,40476,2.125,11.852305896088732,3.942712884746092,9.364430753756208,50799.04190694011,582.4775025039212,0.0846427512600059,0.915357248739994,9964,335,10299,0.967472570152442,0.032527429847558,129798969
90650,7420,73058,7231,19384,487800.0,74440.5,49989696,97209,80289,2.125,11.12958097082008,4.151774659513,6.55288451850807,43484.634974469824,514.249668240595,0.090062150481386,0.909937849518614,18990,394,19384,0.9796739579034256,0.0203260420965744,155843186
90660,4480,46300,4201,12511,490300.0,70482.25,31894548,58484,50501,0.0,12.087598190906927,4.058828231156582,6.956361353390393,43921.42766555831,545.3551056699268,0.0831864715550187,0.9168135284449812,12090,421,12511,0.9663496123411398,0.0336503876588602,161342495
90670,1317,11710,1264,3133,492100.0,71639.5,9408751,17172,12974,0.0,10.30617088607595,4.157995531439515,6.869115501922822,44018.455139431535,547.9123573258794,0.0974256204717126,0.9025743795282872,3091,42,3133,0.986594318544526,0.0134056814554739,17422912
90680,1905,12785,1739,3600,472800.0,64576.75,12149581,25523,14524,0.0,8.447383553766532,4.080555555555556,7.321520516284885,42688.39477408189,476.0248011597383,0.1197328559625447,0.8802671440374552,3591,9,3600,0.9975,0.0025,3773554
90703,4483,50135,4385,13026,762700.0,107220.5,48563756,66844,54520,2.125,12.45564424173318,4.1929986181483185,7.113378505043345,65848.53017362773,726.5237867273054,0.0804292002934702,0.9195707997065296,12978,48,13026,0.9963150621833256,0.0036849378166743,24368579
90704,210,1759,234,553,863800.0,74656.75,4459432,3946,1993,2.125,8.414529914529915,3.560578661844485,11.570286678699516,76983.01979834332,1130.114546376077,0.1174109382839939,0.882589061716006,319,234,553,0.5768535262206148,0.4231464737793852,180598156
90706,4368,43911,4149,11800,535300.0,62456.0,32446237,67529,48060,2.125,11.636297903109185,4.0914406779661014,8.570833867042397,48477.581223487236,480.4785647647677,0.0863295880149812,0.9136704119850187,11561,239,11800,0.9797457627118644,0.0202542372881355,81535935
90710,2049,16590,1786,4622,523400.0,64345.0,16481354,25682,18376,0.0,10.436170212765957,4.0326698398961485,8.134276167534384,47272.33689322673,641.7472938244684,0.097191989551589,0.902808010448411,4550,72,4622,0.9844223279965384,0.0155776720034617,25035616
90712,3461,35542,3387,9239,622800.0,99860.0,26428466,44522,38929,2.125,11.515500442869795,4.2215607749756465,6.236731423993591,54102.30424846708,593.6046448946588,0.0870045467389349,0.912995453261065,9203,36,9239,0.9961034744019917,0.0038965255980084,15730670
90713,3231,35327,3178,9115,638600.0,105882.75,25127746,41703,38505,2.125,12.132787916928883,4.230170049369172,6.031199605223702,55194.05042449616,602.540488693859,0.082534735748604,0.917465264251396,9087,28,9115,0.996928140427866,0.0030718595721338,13535495
90715,1338,13392,1312,3580,555400.0,75783.25,10568759,21798,14704,2.125,11.227134146341465,4.114525139664805,7.328796270943777,49432.01875750094,484.849940361501,0.089227421109902,0.910772578890098,3507,73,3580,0.979608938547486,0.0203910614525139,25518454
90716,708,6669,638,1882,442000.0,55840.25,4338822,10547,7307,0.0,11.56269592476489,3.919766206163656,7.915437341344282,40438.232549653825,411.37972883284345,0.0873135349664705,0.9126864650335296,1791,91,1882,0.9516471838469712,0.0483528161530286,28426807
90717,1721,17059,1691,4505,649400.0,75388.0,15239621,26132,18750,2.125,11.105854523950326,4.168701442841288,8.614103040271662,57825.17131756439,583.1785167610592,0.0901866666666666,0.9098133333333334,4433,72,4505,0.9840177580466148,0.0159822419533851,19445709
90720,2377,21801,2104,5825,1004200.0,109048.5,27137348,30661,23905,0.0,11.491444866920151,4.150729613733906,9.208746566894549,86572.3387309752,885.077068588761,0.08801505961096,0.91198494038904,5821,4,5825,0.99931330472103,0.0006866952789699,2493926
90723,2436,23777,2347,6819,411900.0,56626.75,15563427,37945,26124,2.125,11.168726033233916,3.844112039888546,7.273947383524571,37636.24716412427,410.1575174594808,0.0898407594549073,0.9101592405450928,6515,304,6819,0.9554186830913624,0.0445813169086376,92249155
90731,4230,38118,4037,11073,657700.0,55660.5,36576603,63132,42155,0.0,10.489967797869705,3.824437821728529,11.816279048876671,60190.21085036956,579.3670880060824,0.0957656268532795,0.9042343731467204,10801,272,11073,0.9754357446039916,0.0245642553960083,79511723
90732,1786,17731,1683,4637,657400.0,102780.25,23809350,33624,19414,0.0,11.59655377302436,4.208971317662281,6.396170470494088,56965.35077802355,708.1058172733761,0.0866900175131348,0.9133099824868652,4622,15,4637,0.9967651498813888,0.0032348501186111,12164976
90740,1735,18241,1679,4747,442000.0,71040.5,32279431,52400,19920,0.0,11.897558070279928,4.208131451443017,6.2218030560032656,39566.716113996255,616.0196755725191,0.0842871485943775,0.9157128514056224,4741,6,4747,0.9987360438171476,0.0012639561828523,6754583
90744,2529,25710,2285,7522,471000.0,51189.25,18628805,34649,27995,2.125,12.358424507658643,3.7541877160329697,9.201150632212816,43437.021849854886,537.6433663309186,0.0816217181639578,0.9183782818360422,7110,412,7522,0.9452273331560757,0.0547726668439244,112781174
90745,3887,39775,3536,10565,516000.0,84366.75,32747601,55723,43311,2.125,12.347850678733032,4.132702318977756,6.116153579461103,45490.89711495361,587.6855338011234,0.0816420770704901,0.9183579229295098,10390,175,10565,0.9834358731661146,0.0165641268338854,59779359
90746,2803,26226,2657,7101,585600.0,89634.75,28500944,32728,28883,2.125,10.925479864508844,4.088015772426419,6.5331804908252655,51352.66227828886,870.8428257149841,0.0919918291036249,0.908008170896375,6957,144,7101,0.9797211660329532,0.0202788339670468,82604283
90755,812,6361,698,1777,553100.0,79071.75,8467614,14802,7059,0.0,10.276504297994268,4.036578503095104,6.994912848141087,49041.900952555705,572.0587758411026,0.0988808613118005,0.9011191386881996,1750,27,1777,0.9848058525604952,0.0151941474395047,10386044
90802,1031,7990,1075,2269,460300.0,57908.25,18927225,57638,9065,0.0,8.391627906976744,3.97576024680476,7.94878104587861,41972.84158371601,328.3810159963913,0.1185879757308328,0.8814120242691671,2178,91,2269,0.9598942265315116,0.0401057734684883,19413297
90803,3056,29377,3001,7706,943000.0,92201.5,44045574,60131,32378,0.0,10.807397534155282,4.208798338956657,10.227599334067234,82489.68979759814,732.4936222580699,0.0926863919945642,0.9073136080054358,7672,34,7706,0.9955878536205556,0.0044121463794445,16719967
90804,1914,16766,1810,4837,541000.0,52644.25,14815227,36055,18576,0.0,10.320441988950275,3.861897870580939,10.276525926383224,49764.0013532541,410.9063098044654,0.0974375538329026,0.9025624461670974,4669,168,4837,0.9652677279305356,0.0347322720694645,40025921
90805,5902,54114,5467,15231,469100.0,52703.75,35655129,73913,59581,0.0,10.977867203219317,3.9403847416453286,8.900694922088087,43145.78130358433,482.393205525415,0.0917574394521743,0.9082425605478256,14700,531,15231,0.9651368918652748,0.0348631081347252,164408883
90806,2298,22469,2180,6530,568400.0,55402.0,16725506,31389,24649,0.0,11.361009174311926,3.792802450229709,10.259557416699758,52039.98302167179,532.8460925802033,0.0884417217737027,0.9115582782262972,6220,310,6530,0.9525267993874426,0.0474732006125574,83367835
90807,2641,27392,2564,7181,661100.0,79006.0,28401233,42524,29956,0.0,11.71333853354134,4.182286589611475,8.367718907424752,58622.296693327626,667.8871460822124,0.0855922018961143,0.9144077981038856,7113,68,7181,0.99053056677343,0.0094694332265701,29809551
90808,4567,50316,4468,12935,708300.0,112630.0,41460967,59432,54784,0.0,12.28357206803939,4.242984151526865,6.288733019621771,60893.08104041886,697.6202550814376,0.0815566588785046,0.9184433411214952,12915,20,12935,0.9984538074990336,0.0015461925009663,8650012
90810,2355,23873,2147,6580,464500.0,61623.75,16646377,29874,26020,0.0,12.216115510013973,3.986018237082067,7.537678249051705,42116.99272375683,557.2195554662918,0.0825134511913912,0.9174865488086088,6372,208,6580,0.96838905775076,0.0316109422492401,67042900
90813,1780,14768,1763,4694,430500.0,40141.5,11691158,27971,16531,0.0,9.386273397617698,3.5253515125692374,10.724561862411718,40612.571573992645,417.97425905402025,0.1066481156614844,0.8933518843385155,4295,399,4694,0.9149978696207924,0.0850021303792075,88521775
90814,1377,14129,1361,3776,738900.0,77344.5,16702406,28657,15490,0.0,11.393093313739897,4.106461864406779,9.553361906793633,65644.8450083772,582.838608367938,0.0878631375080697,0.9121368624919304,3728,48,3776,0.9872881355932204,0.0127118644067796,13601819
90815,3872,41613,3818,10765,701600.0,96560.5,40345918,60787,45431,0.0,11.913305395495025,4.225267069205759,7.26591100916006,61126.030874806034,663.7260927500946,0.0840395324778235,0.9159604675221764,10746,19,10765,0.9982350209010684,0.0017649790989317,12784876
91001,4543,40896,4315,11259,887100.0,104648.75,55216547,53656,45211,2.125,10.530475086906142,4.03579358735234,8.476928773635615,76749.6109213844,1029.0842962576412,0.0954413748866426,0.9045586251133574,10591,668,11259,0.9406696864730438,0.0593303135269562,502017901
91006,3851,31888,3741,8337,1074000.0,105695.5,43144417,42924,35629,2.125,9.553327987169206,4.286793810723282,10.16126514373838,92839.77474995203,1005.1350526511976,0.1049987369839176,0.8950012630160824,8204,133,8337,0.984047019311503,0.015952980688497,144971802
91007,2645,22202,2558,5738,1056600.0,84075.5,31990871,37939,24760,2.125,9.713448006254886,4.330254444057163,12.567275841356876,93178.95412509528,843.2186140910409,0.1033117932148626,0.8966882067851373,5662,76,5738,0.9867549668874172,0.0132450331125827,68391805
91010,2094,19829,1975,5316,560900.0,79631.75,19005946,29114,21804,2.125,11.100253164556962,4.123965387509406,7.04367290684934,49702.40513614932,652.811224840283,0.0905797101449275,0.9094202898550724,5157,159,5316,0.9700902934537246,0.0299097065462753,75688699
91011,2895,23603,2833,6490,1671000.0,173742.5,56928871,29572,26436,0.0,9.35333568655136,4.0828967642526965,9.617681338762823,138496.00929357484,1925.093703503314,0.1071644726887577,0.8928355273112423,6113,377,6490,0.9419106317411402,0.0580893682588597,530375224
91016,3606,35182,3455,9390,707400.0,80696.0,37430611,55973,38637,2.125,11.226628075253256,4.130777422790202,8.766233766233766,62610.389718038205,668.7261894127525,0.0894220565778916,0.9105779434221084,9091,299,9390,0.968157614483493,0.0318423855165069,208033793
91020,468,4409,450,1183,719600.0,66624.75,5084341,9889,4859,2.125,10.837777777777776,4.122569737954353,10.800790997339575,64788.954967785954,514.141065830721,0.092611648487343,0.907388351512657,1144,39,1183,0.967032967032967,0.0329670329670329,13401885
91024,1327,12399,1282,3475,1048300.0,105305.25,19161359,19145,13681,0.0,10.706708268330733,3.949928057553957,9.954869296640004,90647.17483470448,1000.854478976234,0.0937066003947079,0.906293399605292,3151,324,3475,0.9067625899280576,0.0932374100719424,221494518
91030,1701,19728,1685,5169,1174400.0,106534.75,29031764,33766,21413,0.0,12.717507418397624,4.1456761462565295,11.023633133789678,101449.29349802448,859.7928093348338,0.0786905151076449,0.9213094848923552,5019,150,5169,0.9709808473592572,0.0290191526407428,88303998
91040,3019,20930,2872,5938,638100.0,89714.5,27196764,28939,23802,2.125,8.338788300835654,4.033176153587067,7.112562629229389,55952.149087614365,939.7962611009364,0.1206621292328375,0.8793378707671624,5510,428,5938,0.927921859211856,0.0720781407881441,296956951
91042,3304,22401,3104,6665,617400.0,64901.75,27563244,34606,25505,2.125,8.28125,3.856714178544636,9.512840562850773,55718.85420023628,796.4874299254465,0.1217016271319349,0.8782983728680651,5967,698,6665,0.8952738184546136,0.1047261815453863,423667687
91101,403,2914,329,891,615200.0,71741.25,9396873,29909,3243,2.125,10.082066869300911,3.722783389450056,8.575261791507675,55022.79218788125,314.18211909458694,0.1014492753623188,0.8985507246376812,829,62,891,0.9304152637485972,0.0695847362514029,20891401
91103,2165,17663,2119,5012,780200.0,71398.75,25426539,29089,19782,2.125,9.357243983010854,3.9561053471668,10.927362173707523,69810.08517240276,874.0946405857884,0.1071175816398746,0.8928824183601254,4712,300,5012,0.940143655227454,0.0598563447725458,217411272
91104,3267,32906,3203,8957,836500.0,78816.0,33649786,45971,36109,2.125,11.293474867311897,4.038517360723456,10.61332724319935,74191.53422458349,731.9785516956342,0.0887036472901492,0.9112963527098508,8704,253,8957,0.9717539354694652,0.0282460645305347,101023435
91105,1258,11527,1296,3078,1306200.0,133901.0,31419171,25452,12823,2.125,9.864969135802468,4.1536712150747235,9.754968222791463,110649.38022198812,1234.4480198019803,0.10106839273181,0.89893160726819,2921,157,3078,0.9489928525016244,0.0510071474983755,252107854
91106,1397,13156,1317,3533,811200.0,82859.25,26930864,34769,14473,2.125,11.0501138952164,4.119162185111803,9.79009585532092,71629.78001435834,774.5653887083321,0.0909970289504594,0.9090029710495404,3449,84,3533,0.9762241720917068,0.0237758279082932,30309619
91107,3673,34159,3528,9177,913700.0,102607.5,44310969,51709,37687,2.125,10.723356009070296,4.122480113326795,8.904807153473186,79185.92804177885,856.9295287087355,0.0936131822644413,0.9063868177355586,8914,263,9177,0.9713413969706876,0.0286586030293124,222115390
91108,1890,16663,1902,4360,2000001.0,164631.5,32415657,19544,18565,0.0,9.75446898002103,4.255275229357798,12.148349495691894,166507.6668830487,1658.5989050347932,0.1024508483705898,0.8975491516294102,4311,49,4360,0.9887614678899084,0.0112385321100917,73817426
91201,1637,13500,1579,3724,916000.0,59152.5,15729646,23166,15079,2.125,9.586447118429383,4.064715359828142,15.485397912176154,83364.62438813194,678.9970646637313,0.1047151667882485,0.8952848332117515,3620,104,3724,0.9720730397422128,0.0279269602577873,59619850
91202,1615,12918,1523,3543,876700.0,77671.25,21333015,27340,14441,2.125,9.542350623768876,4.10189105278013,11.287316735600369,77858.01764203128,780.2858449158741,0.1054636105532857,0.8945363894467142,3413,130,3543,0.9633079311318092,0.0366920688681908,131444868
91203,409,3822,401,1072,592600.0,61120.75,6062455,19543,4223,2.125,10.551122194513717,3.9468283582089554,9.69556165459357,53771.994266394344,310.21107301847206,0.0949561922803694,0.9050438077196306,1039,33,1072,0.9692164179104478,0.0307835820895522,11647504
91204,362,3502,352,1068,561800.0,53414.25,4280827,13480,3854,2.125,10.977272727272728,3.617977528089888,10.517792536635822,51608.36181190499,317.5687685459941,0.0913336792942397,0.9086663207057604,1003,65,1068,0.9391385767790262,0.0608614232209737,15968124
91205,1108,11148,1089,3187,677200.0,46163.0,12395133,27867,12237,2.125,11.254361799816346,3.8456228427988703,14.669757164828976,63054.39185291732,444.7961029174292,0.0889924000980632,0.9110075999019368,3068,119,3187,0.9626608095387512,0.0373391904612488,36966625
91206,2100,15090,2023,4509,910500.0,72653.25,29777598,35554,17113,2.125,8.497281265447356,3.812375249500998,12.53213035893095,81342.18879703643,837.5315857568769,0.1182142231052416,0.8817857768947583,3899,610,4509,0.8647150144156133,0.1352849855843867,541720476
91207,1156,9298,1131,2566,1092700.0,90733.25,18309581,13853,10429,2.125,9.24314765694076,4.074045206547155,12.042994161456798,95719.22830740068,1321.7051180249766,0.108447598043916,0.891552401956084,2445,121,2566,0.9528448947778644,0.0471551052221356,166138226
91208,2171,15504,2062,4451,1054700.0,105797.5,28190475,23810,17566,2.125,8.571774975751698,3.97101774882049,9.969044637160614,91163.82370369708,1183.9762704745906,0.1173858590458841,0.8826141409541159,4064,387,4451,0.9130532464614692,0.0869467535385306,397352090
91214,3934,31723,3696,8668,851700.0,107597.5,38070335,43463,35419,0.0,9.64745670995671,4.113636363636363,7.915611422198471,73510.16533473624,875.92515472931,0.1043507721844207,0.8956492278155792,8411,257,8668,0.9703507152745732,0.0296492847254268,209380524
91301,3407,25053,3462,7083,871000.0,129529.5,54990992,41880,28515,0.0,8.220681686886193,4.018071438655936,6.724336927109269,73991.23904040092,1313.060936007641,0.1214097843240399,0.8785902156759601,6504,579,7083,0.918254976704786,0.0817450232952139,660602347
91302,4177,23501,4150,6931,1341400.0,139846.5,93613989,39799,27651,2.125,6.669397590361446,3.993363151060453,9.591945454480449,113214.5475702126,2352.1693761149777,0.1500849878847057,0.8499150121152942,6100,831,6931,0.8801038811138364,0.1198961188861636,1410755429
91303,1352,8552,1238,2419,536400.0,61430.5,11058349,24216,9790,0.0,8.0,4.094253823894171,8.731818884755944,48650.141185781,456.65464981830195,0.1264555669050051,0.8735444330949949,2344,75,2419,0.9689954526663912,0.0310045473336089,32304973
91306,4332,31894,4056,8735,592400.0,72319.25,36506347,45604,35950,2.125,8.93145956607495,4.147223812249571,8.191456631533098,52945.58705021055,800.5075651258661,0.1128233657858136,0.8871766342141864,8579,156,8735,0.9821408128219804,0.0178591871780194,78131199
91307,4262,28802,3990,7951,714600.0,120518.0,46672944,36861,32792,0.0,8.28671679197995,4.158470632624827,5.929404736221975,61079.249317457005,1266.187678033694,0.1216760185411075,0.8783239814588925,7712,239,7951,0.969940887938624,0.0300591120613759,460884435
91316,3227,19472,3142,5415,724500.0,76883.75,49689669,42002,22614,2.125,7.224379376193507,4.191874422899354,9.42331767115938,64399.71481075794,1183.03102233227,0.1389404793490758,0.8610595206509242,5270,145,5415,0.9732225300092336,0.0267774699907663,220444967
91320,5899,46486,5855,12308,755800.0,122518.5,65168407,66665,52341,0.0,8.947053800170794,4.256174845628859,6.168864293963769,64509.976341583664,977.550543763594,0.1118625933780401,0.8881374066219598,12184,124,12308,0.9899252518687032,0.0100747481312967,176221353
91321,2656,18511,2608,5064,513500.0,72857.0,32510477,40100,21119,2.125,8.116180981595091,4.179897314375987,7.048053035398109,45863.554437237835,810.7350872817955,0.1234906955821771,0.8765093044178228,4851,213,5064,0.9579383886255924,0.0420616113744075,207307518
91324,2639,18964,2476,5097,680200.0,82026.5,28419762,32606,21440,2.125,8.724959612277868,4.238375515008829,8.292442076645962,60115.96683873754,871.6114212108201,0.1154850746268656,0.8845149253731344,5039,58,5097,0.9886207573082204,0.0113792426917794,37517045
91325,2947,21785,2688,5921,720900.0,71300.5,35934209,38211,24473,2.125,9.200892857142858,4.176997128863368,10.110728536265524,64512.03786881129,940.4152992593756,0.1098353287296204,0.8901646712703796,5827,94,5921,0.9841243033271408,0.0158756966728593,78024880
91326,6001,36924,5201,10704,846700.0,120335.0,73605215,54636,42125,0.0,8.253220534512593,4.010183109118087,7.036190634478747,72379.6786854151,1347.192601947434,0.1234658753709198,0.8765341246290801,10554,150,10704,0.9859865470852018,0.0140134529147982,165840427
91331,5769,50447,5396,14385,487600.0,65157.75,39727166,64708,55843,2.125,10.41808747220163,3.907959680222454,7.483376881491457,43989.090471340656,613.9451999752736,0.0966280464874738,0.9033719535125262,13527,858,14385,0.940354535974974,0.059645464025026,339774023
91335,6359,44318,5870,12310,580500.0,64516.0,48323830,69777,50188,2.125,8.633219761499149,4.116734362307067,8.997767995535991,52416.918683921016,692.5466844375654,0.1169602295369411,0.8830397704630589,11974,336,12310,0.9727051177904142,0.0272948822095857,156510085
91340,2384,20012,2210,5814,515000.0,60769.75,15855107,25265,22222,0.0,10.13393665158371,3.852081183350533,8.474611134651697,46755.073472380005,627.5522264001584,0.0994509945099451,0.9005490054900549,5483,331,5814,0.9430684554523564,0.0569315445476436,115562349
91342,8396,58120,7811,16958,520900.0,77010.0,67216272,82376,65931,2.125,8.515683011138139,3.9223965090222905,6.764056616023893,46295.265329685746,815.9691172186074,0.1184723422972501,0.8815276577027499,16006,952,16958,0.9438613043991037,0.0561386956008963,478056778
91343,4534,33319,4259,9089,608500.0,66968.75,40421599,48294,37578,0.0,8.887767081474525,4.164704587963472,9.086327578161455,54760.710952246394,836.9900815836336,0.1133375911437543,0.8866624088562457,8904,185,9089,0.9796457256023764,0.0203542743976235,104765916
91344,6950,50920,6587,13895,690300.0,99104.25,72545246,66240,57507,0.0,8.785486564445119,4.164807484706729,6.965392503348746,60005.593192157605,1095.1878925120773,0.1145425774253569,0.8854574225746431,13608,287,13895,0.979345088161209,0.0206549118387909,232212601
91345,1930,14914,1722,4168,558000.0,79915.0,14388622,19198,16636,0.0,9.781649245063878,4.04126679462572,6.982418819996246,49429.87840105343,749.4854672361704,0.1035104592450108,0.8964895407549892,4070,98,4168,0.9764875239923224,0.0235124760076775,44807334
91350,6615,39105,5659,11160,605800.0,116449.5,53778969,56180,44764,0.0,8.07916593037639,4.096774193548387,5.202255054766229,51932.18511781771,957.2618191527234,0.1264185506210347,0.8735814493789652,10971,189,11160,0.9830645161290322,0.0169354838709677,181642379
91351,3837,27366,3660,7571,471900.0,84645.25,33124302,40977,31026,0.0,8.525409836065574,4.121384229295998,5.575032267020299,41590.92828267785,808.363276960246,0.1179655772577838,0.8820344227422162,7427,144,7571,0.9809800554748382,0.0190199445251618,84275820
91352,3396,26049,3240,7651,584100.0,59025.75,27139168,37446,29289,0.0,9.087962962962964,3.8485165337864338,9.89568112222208,53168.97916976882,724.7547935694066,0.1106217351224009,0.8893782648775991,7105,546,7651,0.9286367795059468,0.071363220494053,267285971
91354,4808,31551,4705,8421,648600.0,130461.75,44430288,48189,36256,2.125,7.7277364505844846,4.317658235363971,4.971572127462647,55064.86678974231,922.0006225487144,0.1297716240070609,0.8702283759929391,8372,49,8421,0.9941812136325852,0.0058187863674147,51918900
91355,3367,27594,3342,7159,600200.0,97170.0,40979424,53549,30936,2.125,9.264213046080192,4.3247660287749685,6.176803540187301,52263.03058166964,765.2696408896525,0.1080294802172226,0.8919705197827773,7152,7,7159,0.9990222098058388,0.0009777901941611,7831958
91356,3765,20588,3624,5811,1023000.0,80812.0,60629823,40167,24212,2.125,6.7199227373068435,4.190844949234211,12.65901103796466,90531.9288569375,1509.4436477705578,0.1496778456963489,0.8503221543036511,5582,229,5811,0.9605919807262088,0.039408019273791,373466485
91360,4565,41013,4537,10662,735100.0,97369.0,51973634,62424,45550,0.0,10.045845272206304,4.274807728381167,7.549630785979111,63998.18544256315,832.590574138152,0.0996048298572996,0.9003951701427003,10590,72,10662,0.9932470455824424,0.0067529544175576,92046526
91362,4768,33549,4738,8967,878300.0,118686.5,68509058,56880,38287,0.0,8.087167581257916,4.273112523698003,7.400167668605949,75169.62478558869,1204.4489803094234,0.1237495755739546,0.8762504244260454,8815,152,8967,0.9830489572878331,0.0169510427121668,275160174
91364,5173,29382,5021,8274,949000.0,109117.75,58653028,42808,34403,0.0,6.8820952001593305,4.1763355088228185,8.69702683568897,81809.055253371,1370.141749205756,0.1459465744266488,0.8540534255733512,7923,351,8274,0.957577955039884,0.042422044960116,360655776
91367,4758,31172,4675,8468,786200.0,94449.75,60602975,72714,35847,0.0,7.685561497326203,4.243032593292395,8.324002975126986,68628.85228658814,833.4430095992518,0.1304153764610706,0.8695846235389293,8353,115,8468,0.9864194615021256,0.0135805384978743,107969710
91377,1769,12934,1745,3462,823300.0,135350.0,23840845,23578,14679,0.0,8.425787965616045,4.246967071057193,6.082748429996306,69678.95456359508,1011.1478921028076,0.1188773077185094,0.8811226922814905,3392,70,3462,0.979780473714616,0.0202195262853841,82724601
91381,2546,15364,2445,4463,851300.0,135564.5,33224275,28310,17809,0.0,7.325153374233129,4.012995742773919,6.2796676120960875,72039.04451071746,1173.5879547862946,0.137290134201808,0.862709865798192,4342,121,4463,0.972888191799238,0.0271118082007618,160196618
91384,3379,21200,3493,5927,579800.0,113020.0,32529182,28312,24693,2.125,7.036644718007444,4.146954614476126,5.130065475137144,49831.03140723023,1148.9538711500425,0.1414570931033086,0.8585429068966913,5073,854,5927,0.8559136156571622,0.1440863843428378,742387230
91390,3044,18096,3024,5321,647600.0,122991.75,35851589,25423,21120,0.0,6.9907407407407405,3.972937417778613,5.2653938170649655,55256.573545786574,1410.2029264838925,0.1431818181818182,0.8568181818181818,4571,750,5321,0.8590490509302763,0.1409509490697237,588408841
91401,3108,21251,3021,5969,798900.0,57722.75,31805959,37465,24272,0.0,8.0632240979808,4.080918076729771,13.84029693664976,72869.68595619276,848.9512611770987,0.124464403427818,0.8755355965721819,5845,124,5969,0.9792260010051936,0.0207739989948065,52996074
91402,2771,20844,2599,5942,483700.0,47267.75,20671541,35007,23443,0.0,9.086186994998076,3.974251093907775,10.233192821744211,44938.565202983526,590.4973576713229,0.1108646504286994,0.8891353495713006,5701,241,5942,0.9594412655671491,0.0405587344328508,98893848
91403,2549,16071,2558,4488,1129100.0,101566.5,42792339,38381,18629,0.0,7.279124315871774,4.148841354723707,11.116854474654536,97940.1511630213,1114.9354889137855,0.1373127918836223,0.8626872081163777,4147,341,4488,0.9240196078431372,0.0759803921568627,490434173
91405,2749,17282,2616,4982,581600.0,48552.0,20543791,33645,19898,0.0,7.657110091743119,4.020674427940586,11.97890921074312,53899.80936935843,610.6045772031506,0.1314704995476932,0.8685295004523068,4822,160,4982,0.9678843837816138,0.0321156162183861,69745554
91406,4190,30778,3931,8445,608600.0,60442.25,34288888,47739,34709,0.0,8.895446451284661,4.140674955595027,10.069115560721183,55279.81428959649,718.2573577159136,0.113255927857328,0.8867440721426719,8265,180,8445,0.9786856127886324,0.0213143872113676,83547803
91411,1270,9512,1213,2637,759300.0,60626.0,12304497,20477,10725,0.0,8.888705688375927,4.088737201365188,12.524329495595948,68949.05239072653,600.8935390926405,0.1131002331002331,0.8868997668997669,2578,59,2637,0.9776260902540768,0.0223739097459233,21831146
91423,2778,19965,2762,5504,1066600.0,90793.25,51547952,47844,22727,0.0,8.234250543084721,4.132085755813954,11.74756934023179,93427.48895015934,1077.4172728032772,0.1215294583535002,0.8784705416464997,5051,453,5504,0.9176962209302324,0.0823037790697674,706251623
91436,2767,17561,2717,4846,1545300.0,158677.5,56829730,23938,20278,2.125,7.481781376518219,4.194799834915394,9.738620787446235,129047.83810633984,2374.0383490684267,0.1339875727389289,0.8660124272610711,4632,214,4846,0.9558398679323152,0.0441601320676846,344093321
91501,1298,10357,1205,2905,827400.0,72598.75,17826934,24904,11562,2.125,9.67219917012448,4.0120481927710845,11.396890442328552,73923.1623723237,715.8261323482171,0.1042207230582944,0.8957792769417056,2761,144,2905,0.9504302925989672,0.0495697074010327,131897892
91502,190,1809,196,521,761400.0,47945.25,3116230,10092,2005,2.125,10.198979591836734,3.836852207293666,15.880613825144303,70645.1167531904,308.7822037257233,0.0977556109725685,0.9022443890274314,508,13,521,0.9750479846449136,0.0249520153550863,3496853
91504,2183,18641,2055,5120,819100.0,83833.25,24958168,32784,20696,2.125,10.133333333333333,4.0671875,9.770586253067846,72252.79932402239,761.2911176183504,0.0992945496714341,0.9007054503285659,4982,138,5120,0.973046875,0.026953125,110725590
91505,2831,29778,2748,7894,812500.0,88855.0,30834074,50404,32526,2.125,11.866448326055313,4.130858880162148,9.1441111923921,71304.69804478766,611.7386318546147,0.0844862571481276,0.9155137428518724,7801,93,7894,0.9882189004307068,0.0117810995692931,32922493
91506,1887,19208,1800,5147,850600.0,82262.0,19331538,28218,21008,2.125,11.719444444444443,4.0985039829026615,10.340132746590164,75156.84847286815,685.0782479268552,0.0856816450875856,0.9143183549124144,5099,48,5147,0.9906741791334758,0.0093258208665241,21593553
91601,1976,14180,1887,4046,744500.0,56422.5,20123942,46927,16067,0.0,8.561738208797033,3.9930795847750864,13.19509061101511,68049.1394307782,428.83504166045134,0.1174456961473828,0.8825543038526171,3869,177,4046,0.9562530894710826,0.0437469105289174,50844260
91602,1338,9368,1298,2567,873700.0,82896.5,24315834,29694,10666,0.0,8.248073959938367,4.17062719127386,10.539648839215166,77145.53148294138,818.8803798747222,0.1216951059441215,0.8783048940558785,2537,30,2567,0.9883132060771328,0.0116867939228671,14545091
91604,3244,21770,3232,6095,1263200.0,114667.0,65113642,51065,25002,0.0,7.739480198019802,4.104019688269073,11.016247045793472,108431.16186223643,1275.1129344952512,0.1292696584273258,0.8707303415726741,5568,527,6095,0.9135356849876948,0.0864643150123051,809030351
91605,3586,25334,3438,7412,605900.0,51840.25,25006135,39572,28772,0.0,8.411867364746946,3.901780895844576,11.687829437550938,55812.85416661923,631.9148640452845,0.1194911719727512,0.8805088280272487,7114,298,7412,0.95979492714517,0.04020507285483,125624573
91606,2751,20624,2561,6035,648100.0,52086.75,21603008,36073,23185,0.0,9.127294025771183,3.8732394366197185,12.442703758633431,59674.0574982326,598.8691819366285,0.1104593487168427,0.8895406512831572,5771,264,6035,0.9562551781275892,0.0437448218724109,102625779
91607,2175,15100,2013,4133,864100.0,72698.25,27786781,37569,17113,0.0,8.581718827620467,4.179772562303412,11.886118304085723,77192.63859699355,739.6199260028214,0.1176298720271138,0.8823701279728862,4099,34,4133,0.9917735301233972,0.0082264698766029,20737520
91701,5496,42309,5355,11220,577200.0,100302.75,48009173,53697,47664,0.0,8.92717086834734,4.260695187165775,5.7545780150594075,50121.79460920567,894.0755163230721,0.1123489425981873,0.8876510574018127,11164,56,11220,0.9950089126559716,0.0049910873440285,52180727
91702,4182,36752,3881,9840,474100.0,68399.75,34112625,57512,40633,2.125,10.547281628446276,4.159959349593496,6.931311883449866,42584.63131238999,593.1392578940047,0.0955134988802205,0.9044865011197796,9554,286,9840,0.9709349593495936,0.0290650406504065,134124459
91706,5085,44491,4699,12297,465900.0,67356.5,31218260,59892,49190,0.0,10.550329857416472,4.031552411157193,6.916927096865187,41905.94351799481,521.24256995926,0.0955275462492376,0.9044724537507624,11803,494,12297,0.959827600227698,0.0401723997723021,175308691
91708,2678,7165,1649,2808,488900.0,82879.0,8947419,16286,8814,1.7142857142857142,5.969072164948454,3.5053418803418803,5.898961136114094,43169.455729736765,549.39328257399,0.1870887224869525,0.8129112775130474,2801,7,2808,0.9975071225071224,0.0024928774928774,4551065
91709,11483,72165,11124,19833,676800.0,106229.0,98925341,105279,83289,0.0,7.519597267170083,4.21761710280845,6.371141590337855,58479.16622837175,939.6493222769972,0.1335590534164175,0.8664409465835825,19148,685,19833,0.9654616043967126,0.0345383956032874,718573522
91710,8844,65536,8226,17581,512600.0,84390.25,65993271,89068,73762,1.7142857142857142,9.042061755409676,4.2307036004777885,6.074161410826488,45190.04132647194,740.9313221358962,0.1115208372874922,0.8884791627125078,17507,74,17581,0.9957909106421704,0.0042090893578294,44665652
91711,3295,32282,3267,8420,714400.0,102972.75,46986341,47569,35549,2.125,10.889807162534437,4.225296912114014,6.9377578048561395,61894.50733747664,987.7512876032712,0.0919013193057469,0.908098680694253,8317,103,8420,0.9877672209026128,0.0122327790973871,130366694
91722,3098,28718,2932,7580,513600.0,81643.0,23343016,38807,31650,2.125,10.851296043656207,4.197361477572559,6.290802640765283,45410.69345107026,601.515602855155,0.0926382306477093,0.9073617693522906,7470,110,7580,0.9854881266490764,0.0145118733509234,45731548
91723,1262,12368,1176,3301,579100.0,68352.5,11426764,19113,13544,2.125,11.59013605442177,4.129051802484096,8.47225778135401,52019.17480749556,597.8529796473605,0.086828115770821,0.9131718842291788,3267,34,3301,0.9897000908815512,0.0102999091184489,15171512
91724,2664,21965,2487,5875,613400.0,85513.0,26595167,31121,24452,2.125,9.903096099718535,4.192170212765958,7.173178347151895,54013.48318238635,854.5730214324733,0.1017094716178635,0.8982905283821364,5766,109,5875,0.9814468085106384,0.0185531914893617,95554949
91730,5645,41224,5404,11054,452400.0,73430.5,45463264,92184,46628,0.0,8.67301998519615,4.240003618599602,6.160927679915022,40378.095128928486,493.17955393560703,0.1158960281375997,0.8841039718624003,11019,35,11054,0.9968337253482902,0.0031662746517097,15247308
91731,1505,14639,1428,4089,497100.0,45789.25,9405406,20108,16067,0.0,11.30532212885154,3.948153582783077,10.856259930005406,46320.26181108257,467.7444798090313,0.0888778241115329,0.911122175888467,3907,182,4089,0.9554903399364147,0.0445096600635852,55852948
91732,3862,32031,3550,8952,517800.0,54537.0,21564724,43808,35581,0.0,10.110704225352112,4.00949508489723,9.49447164310468,47475.68949044625,492.25538714390063,0.0997723504117366,0.9002276495882634,8634,318,8952,0.9644772117962468,0.0355227882037533,105534922
91733,2332,21088,2239,5986,486400.0,53271.25,13859212,28231,23327,0.0,10.460026797677534,3.912462412295356,9.13062862238074,44692.93427996971,490.9217526832206,0.0959831954387619,0.904016804561238,5688,298,5986,0.9502171734046108,0.0497828265953892,82682703
91737,3517,23630,3439,6376,659500.0,105407.75,38074680,33694,27069,0.0,7.893864495492876,4.257685069008783,6.256655701312285,57022.591824968775,1130.0136522823054,0.1270456980309579,0.8729543019690421,6278,98,6376,0.984629861982434,0.0153701380175658,144469286
91739,5722,33662,5575,9144,648400.0,115879.75,48426492,49334,39237,0.0,7.064394618834081,4.307086614173229,5.595455633965382,55607.449102107705,981.604816151133,0.1420852766521395,0.8579147233478605,9062,82,9144,0.9910323709536308,0.0089676290463692,93258079
91740,2428,22373,2350,5874,590200.0,87666.75,21364008,33006,24723,2.125,10.553617021276596,4.222165474974464,6.732312992097916,51857.002724727914,647.276495182694,0.0950531893378635,0.9049468106621364,5808,66,5874,0.9887640449438202,0.0112359550561797,32253067
91741,3159,28752,2946,7675,757100.0,109625.0,38325018,38112,31698,2.125,10.831975560081466,4.1577850162866445,6.906271379703535,65240.12887713403,1005.5892632241812,0.0929396176414915,0.9070603823585084,7463,212,7675,0.9723778501628664,0.0276221498371335,269029928
91744,6413,51410,6099,14237,463200.0,72971.75,40383681,65465,57509,0.0,9.48073454664699,4.061459577158109,6.347661937667659,41365.166004370745,616.8743756205606,0.106052965622772,0.8939470343772279,13622,615,14237,0.9568026971974432,0.0431973028025567,241897907
91745,5598,48802,5499,13046,647300.0,88377.25,54058768,66015,54301,0.0,9.89270776504819,4.169860493637897,7.3242831158471216,56833.69736965418,818.8861319397107,0.1012688532439549,0.898731146756045,12692,354,13046,0.97286524605243,0.0271347539475701,270593187
91746,2360,20155,2323,5513,488400.0,73965.25,15412344,24891,22478,0.0,9.69220835126991,4.083983312171232,6.603100780434056,43562.993834865294,619.1934434132819,0.1033454933712963,0.8966545066287036,5292,221,5513,0.9599129330672956,0.0400870669327045,88927557
91748,5027,35651,4823,9624,663600.0,74142.25,39201931,50273,40474,0.0,8.434169603980925,4.226724854530341,8.950362310288668,59177.39765893859,779.7810156545263,0.1191629194050501,0.8808370805949498,9442,182,9624,0.981088944305902,0.018911055694098,129494869
91750,4164,35770,4047,9509,630400.0,91265.5,42033585,48185,39817,0.0,9.867556214479862,4.1996003785887055,6.907319852518202,55194.015492049526,872.3375531804503,0.101640003013788,0.8983599969862119,9359,150,9509,0.9842254706067936,0.0157745293932064,136543575
91752,5144,26498,4436,7572,521900.0,88161.25,29827222,41467,30934,0.0,7.1330027051397655,4.178816693079767,5.919834394362603,45833.278140790775,719.3002146284998,0.1434020818516842,0.8565979181483158,7497,75,7572,0.9900950871632328,0.009904912836767,36665747
91754,2610,27695,2595,7217,687700.0,65530.75,22524998,38402,30290,0.0,11.678227360308286,4.1991132049327975,10.494309923203993,62009.28415403525,586.5579396906411,0.085671838890723,0.914328161109277,7106,111,7217,0.9846196480532076,0.0153803519467922,39225118
91755,1826,18584,1770,4842,639900.0,59168.75,14350750,27225,20354,0.0,11.531073446327683,4.2152003304419665,10.814830463716069,58235.46905597024,527.1166207529844,0.0869607939471357,0.9130392060528644,4779,63,4842,0.9869888475836432,0.0130111524163568,26453427
91759,78,709,82,242,380000.0,80522.25,1346225,1195,791,0.0,9.597560975609756,3.2520661157024793,4.719192521321746,33639.36651790712,1126.5481171548115,0.1036662452591656,0.8963337547408344,130,112,242,0.5371900826446281,0.4628099173553719,63005605
91761,7429,44153,5714,13282,452900.0,75405.0,41659766,63592,49867,1.7142857142857142,9.027301365068253,3.883601867188677,6.006233008421193,40327.21635203603,655.1101710907033,0.1145847955561794,0.8854152044438206,13202,80,13282,0.993976810721277,0.006023189278723,33287854
91762,7095,39239,5329,11783,437700.0,62665.0,35531364,58473,44568,1.7142857142857142,8.694689435166072,3.932275311890011,6.98476023298492,39626.78805827906,607.6541993740701,0.1195700951355232,0.8804299048644768,11698,85,11783,0.9927862174318934,0.0072137825681065,28601234
91763,2939,23344,2770,6393,423700.0,62965.5,20411167,34093,26114,1.7142857142857142,9.488447653429605,4.111215391834819,6.729081798762815,38342.70386731437,598.6908456281348,0.1060733706058053,0.8939266293941946,6345,48,6393,0.992491787893008,0.007508212106992,20330510
91764,4351,31300,4129,8569,415600.0,61137.75,27712287,52714,35429,1.7142857142857142,8.634294017922015,4.160462130937099,6.797764065573234,37710.220891422294,525.7101908411428,0.1165429450450196,0.8834570549549804,8481,88,8569,0.9897304236200256,0.0102695763799743,35887251
91765,6067,41308,6087,11069,709800.0,99828.5,66143805,65224,47395,0.0,7.78298012157056,4.27997109043274,7.110193982680297,61661.637839407056,1014.102247638906,0.1284312691212153,0.8715687308787847,10614,455,11069,0.9588942090523084,0.0411057909476917,513975073
91767,4171,32054,3906,8802,449500.0,63249.0,28071434,49142,35960,2.125,9.274193548387096,4.115541922290388,7.106831728564878,40660.94305517654,571.2310040291401,0.1086206896551724,0.8913793103448275,8578,224,8802,0.9745512383549192,0.0254487616450806,86656037
91768,2526,18770,2316,5469,427500.0,58526.75,15781437,25946,21086,2.125,9.195164075993093,3.89394770524776,7.30435228335761,38944.2183465194,608.2416172049642,0.1098359100825192,0.8901640899174807,5273,196,5469,0.9641616383251052,0.0358383616748948,69383091
91770,4468,46029,4326,12453,601300.0,59929.5,30482843,58707,50355,2.125,11.672907998150716,4.055006825664498,10.03345597744016,54659.04425682648,519.2369393769056,0.0859100387250521,0.914089961274948,12130,323,12453,0.9740624749056452,0.0259375250943547,92426961
91773,3756,30792,3613,8233,625400.0,90209.75,39893981,47486,34405,0.0,9.562136728480487,4.196283250334021,6.932731772341682,54812.08380549354,840.1208987912227,0.1050138061328295,0.8949861938671705,8053,180,8233,0.9781367666707154,0.0218632333292845,154148529
91775,2397,24415,2356,6328,861400.0,90599.75,22009699,30875,26771,0.0,11.380305602716469,4.237041719342605,9.50775250483583,75467.35574153748,712.8647449392713,0.0880056777856636,0.9119943222143364,6282,46,6328,0.9927307206068268,0.0072692793931731,25070516
91776,2396,22757,2301,6076,698900.0,62222.5,16732370,34861,25058,0.0,10.931334202520643,4.13973008558262,11.232271284503192,63314.92286141159,479.9738963311437,0.0918269614494373,0.9081730385505626,5932,144,6076,0.9763001974983542,0.0236998025016458,49408859
91780,3774,33410,3534,8883,766200.0,78819.0,26574055,44518,36944,0.0,10.521788341822296,4.185973207249803,9.7210063563354,67956.20038225235,596.9283211285323,0.0956582936336076,0.9043417063663924,8789,94,8883,0.9894179894179894,0.0105820105820105,37123469
91784,4215,32093,3852,8720,666800.0,130160.25,45894698,39922,35945,1.7142857142857142,9.4257528556594,4.163761467889908,5.1229157903430576,56621.133056410144,1149.6091879164371,0.1071637223535957,0.8928362776464043,8642,78,8720,0.9910550458715596,0.0089449541284403,104293850
91786,4650,34796,4186,9545,483400.0,64445.5,38332780,64914,38982,1.7142857142857142,9.423315814620162,4.132634887375589,7.500911622999278,43653.47161616127,590.5163755122162,0.1073828946693345,0.8926171053306654,9492,53,9545,0.994447354635935,0.0055526453640649,17560190
91789,5503,42675,5367,11379,790500.0,105917.5,56110395,54494,48042,2.125,8.976709521147756,4.233939713507338,7.463355913800836,68320.79467484899,1029.6618893823172,0.1117147495941051,0.8882852504058948,11210,169,11379,0.9851480797961156,0.0148519202038843,153800834
91790,3812,35877,3674,9520,594000.0,84935.0,30668472,49926,39551,0.0,10.802667392487752,4.169012605042017,6.993583328427621,52336.45468544146,614.2785722869847,0.0928927207908776,0.9071072792091224,9368,152,9520,0.984033613445378,0.0159663865546218,70019312
91791,3198,26586,3135,7013,647400.0,85590.25,33010691,38988,29721,0.0,9.50047846889952,4.246969913018679,7.563945659698389,57002.85108775202,846.6884938955576,0.105480973049359,0.894519026950641,6905,108,7013,0.9846000285184656,0.0153999714815342,74451891
91792,2244,19544,2205,5226,557100.0,83484.25,20213461,34055,21749,0.0,9.881179138321995,4.169154228855722,6.673114988755364,49159.873251392535,593.5533989135222,0.1013839716768587,0.8986160283231412,5161,65,5226,0.9875621890547264,0.0124378109452736,28545106
91801,2674,29107,2677,7848,662100.0,64053.75,25756288,54779,31784,2.125,11.87187149794546,4.049566768603466,10.336631344769042,59823.92815752639,470.1854360247541,0.0842247671784545,0.9157752328215454,7654,194,7848,0.9752803261977574,0.0247196738022426,67337466
91803,2201,23971,2084,6417,643900.0,65650.0,18070553,32327,26055,2.125,12.558541266794624,4.078541374474053,9.808073115003808,58050.361368378566,558.9925758653757,0.0799846478602955,0.9200153521397044,6269,148,6417,0.97693626305127,0.0230637369487299,54174186
91901,2969,15910,3157,4899,644200.0,94893.75,34850357,27079,19067,0.0,5.980044345898005,3.853643600734844,6.788645195284199,56210.3976541609,1286.9883304405628,0.1655740284260764,0.8344259715739235,3341,1558,4899,0.6819759134517248,0.3180240865482751,1659686443
91902,2325,18308,2355,4889,732000.0,104261.75,28339173,25965,20663,0.0,8.76135881104034,4.220290447944365,7.020791421590372,63351.0644135896,1091.4374350086655,0.1139718337124328,0.8860281662875672,4867,22,4889,0.995500102270403,0.004499897729597,20298836
91906,608,3122,723,947,282800.0,48726.25,4553552,4585,3845,0.0,5.159059474412172,3.938753959873284,5.80385315923142,26199.805699944995,993.1411123227916,0.1880364109232769,0.8119635890767231,733,214,947,0.7740232312565998,0.2259767687434002,116195099
91910,5840,51230,6014,13632,549100.0,68764.25,58651499,89661,57244,0.0,9.489524442966411,4.186473004694836,7.985253965541688,49297.750506012686,654.1472769654588,0.1050590454894836,0.8949409545105164,13616,16,13632,0.9988262910798122,0.0011737089201877,8869308
91911,5969,50935,6182,13586,485300.0,64073.25,49563492,84889,57117,0.0,9.20478809446781,4.188429265420286,7.57414365589384,43847.98955339715,583.8623614366996,0.108233975874083,0.891766024125917,13568,18,13586,0.9986751067275136,0.0013248932724863,8467581
91913,6137,37690,5091,10755,578600.0,106877.75,50381773,71447,42781,0.0,8.608721272834414,4.075034867503486,5.413661870688707,49967.87005114183,705.1628899743866,0.119001425866623,0.880998574133377,10745,10,10755,0.99907019990702,0.00092980009298,9772039
91914,2168,15015,2238,4050,739300.0,138102.5,25410023,21542,17253,0.0,7.677837354781055,4.242716049382716,5.353270215962781,62463.29213816926,1179.557283446291,0.129716571031125,0.870283428968875,4022,28,4050,0.9930864197530864,0.0069135802469135,49457337
91915,3148,21989,3199,5946,604600.0,120555.25,31770569,42079,25188,0.0,7.857768052516412,4.227547931382442,5.015127918526982,51675.81685542184,755.0219586967371,0.1270049229791964,0.8729950770208036,5938,8,5946,0.9986545576858392,0.0013454423141607,9903064
91916,290,1812,294,624,479600.0,98514.0,4200529,2975,2106,0.0,7.149659863945578,3.3685897435897436,4.868343585683253,41711.769078709855,1411.9425210084034,0.1396011396011396,0.8603988603988604,349,275,624,0.5592948717948718,0.4407051282051282,223414395
91932,2080,17244,2199,4743,639200.0,58560.0,16222700,33692,19443,0.0,8.787630741246021,4.074214632089395,10.915300546448089,58226.564863591,481.5000593612727,0.113099830273106,0.886900169726894,4732,11,4743,0.9976807927472064,0.0023192072527935,4213527
91935,1590,8660,1758,2683,681300.0,106292.5,21538755,13118,10418,0.0,5.830489192263936,3.820350354081252,6.409671425547428,58864.95099764972,1641.9236926360725,0.168746400460741,0.8312535995392589,1789,894,2683,0.6667909057025717,0.3332090942974282,921363772
91941,4125,35453,4312,9288,684900.0,92337.75,47328081,51614,39765,0.0,9.178571428571429,4.261197243755383,7.41733473037842,59904.44504061528,916.9620839307164,0.1084370677731673,0.8915629322268327,9268,20,9288,0.9978466838931956,0.0021533161068044,23471449
91942,3200,26841,3122,7214,578600.0,66103.5,30477085,62884,29963,0.0,9.622357463164638,4.164263931244802,8.752940464574493,52130.93074511542,484.6556357738057,0.1041951740479925,0.8958048259520075,7211,3,7214,0.9995841419462156,0.0004158580537843,2923527
91945,3017,23156,3003,6338,478800.0,66313.75,20935328,32690,26159,0.0,8.715617715617716,4.129536131271695,7.220222050479727,43126.77186207742,640.4199449372896,0.1147979662831148,0.8852020337168852,6324,14,6338,0.9977911012937836,0.0022088987062164,6318149
91950,3444,28501,3560,7793,450700.0,48019.75,23880145,44300,32061,0.0,8.973314606741573,4.099191582189144,9.38572150000781,41811.35796323508,539.0551918735891,0.1110383331773806,0.8889616668226193,7767,26,7793,0.9966636725266264,0.0033363274733735,10545423
91962,363,2369,353,756,433300.0,121652.25,4628939,3472,2722,0.0,7.739376770538244,3.613756613756614,3.5617919109593124,37005.969104850905,1333.219758064516,0.1296840558412931,0.8703159441587068,528,228,756,0.6984126984126984,0.3015873015873015,200128354
91977,6440,46380,6737,12642,493000.0,69654.5,49270598,69197,53117,0.0,7.840284993320469,4.178136370827401,7.077791097488317,44210.08184499377,712.0337297859734,0.1268332172374192,0.8731667827625808,12583,59,12642,0.9953330169277012,0.0046669830722986,38780359
91978,1354,7394,1175,2227,454100.0,79186.0,10178474,13121,8569,0.0,7.445106382978723,3.928154467894028,5.73459955042558,40258.681151263394,775.739196707568,0.1371221846189753,0.8628778153810246,2146,81,2227,0.9636281993713516,0.0363718006286484,80856725
92003,957,4623,880,1425,720300.0,86389.25,9905696,7527,5503,0.0,6.340909090909091,3.9157894736842103,8.337842960785052,63369.76985441354,1316.0217882290422,0.1599127748500817,0.8400872251499182,1358,67,1425,0.9529824561403508,0.0470175438596491,118933835
92007,1515,12136,1534,3277,1304000.0,112677.25,17899520,20386,13670,0.0,8.898956975228161,4.165700335672872,11.572877399830045,112101.81359871276,878.0300206023742,0.1122165325530358,0.8877834674469641,3275,2,3277,0.9993896856881294,0.0006103143118706,2880850
92008,3009,24294,3161,6545,881300.0,86549.75,37651425,51723,27455,0.0,8.637456501107245,4.171581359816654,10.182582849748266,77521.39362751308,727.9435647584247,0.115133855399745,0.8848661446002549,6526,19,6545,0.9970970206264324,0.0029029793735676,21943782
92009,5816,43345,6188,11545,964200.0,138096.0,85748374,75599,49533,0.0,7.9445701357466065,4.258207016024253,6.982099409106708,81465.36695193834,1134.252754666067,0.1249268164657904,0.8750731835342095,11498,47,11545,0.9959289735816372,0.0040710264183629,77851701
92010,2589,16142,2345,4532,776000.0,103822.5,21941069,28742,18487,0.0,7.987633262260128,4.133053839364519,7.474295070914301,67183.59950709812,763.3800361839816,0.1268458917076864,0.8731541082923135,4523,9,4532,0.9980141218005296,0.0019858781994704,8649476
92011,3369,23339,3195,6438,924700.0,116931.75,36506639,39053,26534,0.0,8.359311424100156,4.148493320907114,7.908031821981626,79241.803521893,934.7973011036285,0.1204115474485565,0.8795884525514435,6428,10,6438,0.9984467225846536,0.0015532774153463,9795344
92014,1920,16281,2018,4363,1827000.0,159135.25,40039121,27478,18299,0.0,9.0193260654113,4.171670868668348,11.480800136990393,152535.88085959636,1457.133743358323,0.1102792502322531,0.8897207497677468,4336,27,4363,0.993811597524639,0.0061884024753609,39701216
92019,5553,36497,5583,10013,576700.0,86001.5,54490022,60109,42080,0.0,7.5317929428622605,4.199540597223609,6.705696993657087,50756.37285471232,906.5201883245436,0.132675855513308,0.867324144486692,9747,266,10013,0.9734345351043644,0.0265654648956356,323365112
92020,4553,35744,4621,9614,576200.0,60334.5,44346162,61923,40365,0.0,8.720406838346678,4.191491574786769,9.55009157281489,52345.36982285914,716.1500896274405,0.1144803666542797,0.8855196333457203,9602,12,9614,0.9987518202621176,0.0012481797378822,11632855
92021,6883,44030,6640,12387,469100.0,59795.5,51889408,73490,50670,0.0,7.6676204819277105,4.110196173407605,7.845071953575101,42650.550564013705,706.074404680909,0.1310440102624827,0.8689559897375173,12064,323,12387,0.9739242754500688,0.0260757245499313,251533949
92024,6505,52939,6476,14317,1063400.0,122377.25,89391891,85322,59415,0.0,9.179122915379864,4.151987148145561,8.689523583836047,90773.56948076445,1047.7003703616886,0.1089960447698392,0.8910039552301607,14238,79,14317,0.9944820842355242,0.0055179157644757,117104602
92025,4139,28697,4168,7959,558600.0,58447.25,40201712,49850,32865,0.0,7.878119001919385,4.12564392511622,9.557335888343763,50893.41394242967,806.4536008024072,0.1268218469496424,0.8731781530503575,7840,119,7959,0.9850483729111698,0.0149516270888302,145967728
92026,7449,43154,7249,12460,539900.0,76798.25,59095689,70571,50403,0.0,6.980686991309146,4.06123595505618,7.030108107932147,47995.64560140407,837.3933910529821,0.1438208043172033,0.8561791956827967,11748,712,12460,0.9428571428571428,0.0571428571428571,778811851
92027,6462,41486,6403,11569,493300.0,68648.0,48711035,61657,47889,0.0,7.488364828986413,4.1445241593914774,7.185934040321641,44294.80060099871,790.0325186110255,0.1337050262064357,0.8662949737935642,11352,217,11569,0.9812429769210822,0.0187570230789177,184437191
92029,3957,22032,3523,6478,690900.0,95272.25,35554538,30540,25555,0.0,7.37695146182231,4.0118863846866315,7.2518493055428,60264.32639294793,1164.1957432874915,0.1378595186851888,0.8621404813148112,6142,336,6478,0.9481321395492436,0.0518678604507564,412223853
92036,888,5378,1000,1760,425900.0,59535.25,12243441,8126,6378,0.0,6.266,3.560227272727273,7.153745050201351,38738.17123191391,1506.6996062023136,0.1567889620570711,0.8432110379429288,1036,724,1760,0.5886363636363636,0.4113636363636364,524487233
92037,4572,36901,4729,9932,1614900.0,113602.5,104909425,81137,41630,0.0,8.769930217805033,4.175694724124043,14.21535617614049,138731.62144064266,1292.9911754193524,0.1135959644487148,0.8864040355512851,9869,63,9932,0.993656866693516,0.006343133306484,108985156
92040,5450,37717,5413,10440,540200.0,81808.25,47586444,57305,43130,0.0,7.974690559763532,4.134770114942529,6.603246005140068,47754.0338480604,830.4064915801414,0.1255042893577556,0.8744957106422444,10143,297,10440,0.971551724137931,0.0284482758620689,269207967
92054,3650,30139,3782,8274,648800.0,62867.5,38419153,65018,33921,0.0,8.934161819143311,4.083756345177665,10.32011770787768,58721.39086328794,590.9002583899843,0.1114943545296424,0.8885056454703576,8263,11,8274,0.9986705342035292,0.0013294657964708,4846480
92056,7715,56553,7851,15220,583700.0,83789.5,64516827,89232,64404,0.0,8.185963571519551,4.222601839684626,6.9662666563232865,51490.539618107425,723.0234332974718,0.1219023663126513,0.8780976336873486,15202,18,15220,0.9988173455978976,0.0011826544021024,10458528
92057,7698,52204,7723,14287,530600.0,80239.25,63561392,85757,59927,0.0,7.756312313867668,4.192762651361377,6.612723822817387,46985.82282451218,741.1802185244353,0.1288734627129674,0.8711265372870326,14251,36,14287,0.9974802267795898,0.0025197732204101,42616165
92058,2450,14388,2294,4146,510400.0,54362.5,18376603,43688,16682,0.0,7.34001743679163,4.061263868789195,9.388825017245344,46810.95826711156,420.63273667826405,0.1375134875914159,0.8624865124085841,4133,13,4146,0.9968644476603956,0.0031355523396044,9376490
92059,80,350,92,157,234200.0,93797.75,1317172,785,442,0.0,4.673913043478261,2.738853503184713,2.4968615984925013,20456.1205711648,1677.9261146496815,0.2081447963800905,0.7918552036199095,86,71,157,0.5477707006369427,0.4522292993630573,63087811
92064,6184,47806,6234,12907,767500.0,112261.75,81662445,65829,54040,0.0,8.660571061918512,4.18300147206942,6.836700835324588,66001.13173716012,1240.5238572665542,0.1153589933382679,0.8846410066617321,12660,247,12907,0.9808630975439684,0.0191369024560316,381480845
92065,7103,33827,7280,10056,593100.0,98126.0,58419337,50585,41107,0.0,5.622252747252747,4.070206841686555,6.04426961253898,51600.80089214478,1154.874705940496,0.1770987909601771,0.8229012090398229,8584,1472,10056,0.8536197295147175,0.1463802704852824,1488175403
92067,2280,11460,2159,2876,2000001.0,191589.25,68572471,14381,13619,0.0,6.364057433997221,4.777468706536856,10.43900427607499,164431.72498106142,4768.268618315833,0.1585285263235186,0.8414714736764813,2658,218,2876,0.9242002781641168,0.0757997218358831,436582371
92069,4932,36572,5428,9844,569500.0,74790.0,44731580,60919,42000,0.0,7.646278555637435,4.2161722876879315,7.614654365556893,50746.542386502035,734.2796171966053,0.1292380952380952,0.8707619047619047,9691,153,9844,0.984457537586347,0.0155424624136529,134793243
92071,6886,49677,6151,13590,524100.0,87460.0,55407738,84072,55828,0.0,9.195740529995122,4.162104488594554,5.992453693116853,46058.78458258547,659.051027690551,0.1101776886150318,0.8898223113849681,13528,62,13590,0.995437821927888,0.0045621780721118,56582091
92075,1334,11262,1420,3080,1442900.0,106915.5,24331937,25526,12682,0.0,8.870422535211267,4.08961038961039,13.495704551725428,124604.97913902352,953.2216955261302,0.111969720864217,0.888030279135783,3076,4,3080,0.9987012987012988,0.0012987012987012,3980271
92078,7348,41963,6995,11917,665300.0,88620.0,62719389,74605,48958,0.0,7.049463902787705,4.137870269363095,7.507334687429474,58400.05353409021,840.6861336371556,0.1428775685281261,0.8571224314718738,11716,201,11917,0.9831333389275824,0.0168666610724175,263574234
92081,3615,22845,3295,6465,599400.0,82582.0,29304490,44285,26140,0.0,8.030349013657057,4.092807424593968,7.258240294495168,52943.294678939776,661.7249633058598,0.1260520275439939,0.8739479724560061,6451,14,6465,0.9978344934261408,0.0021655065738592,14430727
92082,3605,18068,3631,5870,620700.0,94313.25,33064409,24522,21699,0.0,5.968879096667584,3.6921635434412265,6.581259791174623,54188.892311365875,1348.3569447842754,0.1673349002258168,0.8326650997741831,5034,836,5870,0.8575809199318569,0.1424190800681431,916977772
92083,3125,23896,3235,6449,467600.0,68177.5,24612375,42954,27131,0.0,8.352704791344667,4.1899519305318655,6.858567709288255,42013.069797926335,572.9937840480515,0.1192362979617411,0.8807637020382588,6435,14,6449,0.9978291207939216,0.0021708792060784,8981375
92084,5463,37104,5361,10398,600600.0,75716.0,49491109,55969,42465,0.0,7.940123111359821,4.093768032313907,7.932273231549474,53459.15834160678,884.2593042577141,0.1262451430589897,0.8737548569410103,10050,348,10398,0.966532025389498,0.033467974610502,420210270
92086,345,1371,555,584,265800.0,41329.5,2855959,2464,1926,0.0,3.091891891891892,2.9383561643835616,6.431241607084528,25006.275536329544,1159.0742694805194,0.2881619937694704,0.7118380062305296,292,292,584,0.5,0.5,137196159
92091,651,2854,618,828,1359400.0,153549.25,11058964,4632,3472,0.0,5.671521035598706,4.233091787439614,8.8531855414468,113835.65786023768,2387.513816925734,0.1779953917050691,0.8220046082949308,815,13,828,0.9842995169082126,0.0157004830917874,108064280
92101,812,7153,1343,1960,626000.0,71824.0,33248635,99643,8496,0.0,5.930752047654505,4.063775510204081,8.715749610158165,55982.95991227666,333.67757895687606,0.1580743879472693,0.8419256120527306,1931,29,1960,0.985204081632653,0.0147959183673469,7366115
92102,3113,23651,3099,6968,477100.0,53414.75,20629270,42773,26750,0.0,8.636334301387544,3.8409873708381177,8.931989759382942,43827.568970558925,482.296542211208,0.1158504672897196,0.8841495327102804,6736,232,6968,0.9667049368541906,0.0332950631458094,55954132
92103,2645,22319,2761,5966,835300.0,79841.25,40186213,68652,25080,0.0,9.041651575516118,4.184378142809252,10.4620105521895,74000.27711602331,585.3611402435472,0.1100877192982456,0.8899122807017544,5903,63,5966,0.9894401609118336,0.0105598390881662,35607114
92104,3804,31652,3955,8602,679300.0,71300.25,32206389,75969,35607,0.0,8.964854614412136,4.121832132062311,9.527315822875796,60789.348140822105,423.9411996998776,0.1110736652905327,0.8889263347094672,8530,72,8602,0.9916298535224366,0.0083701464775633,21420543
92105,4258,35549,4295,9932,459200.0,46042.25,26254649,55765,39844,0.0,9.268218859138534,4.00795408779702,9.97344830020253,42766.7448941754,470.8087330763024,0.1077954020680654,0.8922045979319345,9716,216,9932,0.9782521143777688,0.0217478856222311,45746708
92106,2271,20026,2310,5340,1070000.0,109459.25,32064756,32678,22336,0.0,9.652380952380952,4.175468164794007,9.775327347848627,92215.08518954062,981.2337352347143,0.1034204871060171,0.8965795128939829,5328,12,5340,0.997752808988764,0.0022471910112359,8559098
92107,2832,25789,2844,7057,982300.0,86438.0,29279628,51052,28633,0.0,10.063642756680732,4.0556893864248265,11.364214812929498,86415.4318853702,573.5255817597744,0.0993259525722068,0.9006740474277931,7016,41,7057,0.9941901657928298,0.0058098342071701,18754826
92108,576,4500,729,1255,469300.0,78767.5,15762455,55817,5229,0.0,6.962962962962963,4.044621513944223,5.95804107023836,41625.807523857104,282.39523800992527,0.1394148020654044,0.8605851979345955,1253,2,1255,0.998406374501992,0.0015936254980079,819116
92109,3975,32686,4004,9168,962000.0,86447.5,48528887,93955,36690,0.0,9.156093906093906,3.9988001745200696,11.128141357471298,84628.77100119811,516.5120217125219,0.1091305532842736,0.8908694467157263,9132,36,9168,0.9960732984293194,0.0039267015706806,11419220
92110,1731,15692,1852,4175,688800.0,76721.0,22842780,47352,17544,0.0,9.407667386609072,4.173173652694611,8.977985167033799,61237.93039662688,482.40369994931575,0.105563155494756,0.894436844505244,4151,24,4175,0.994251497005988,0.0057485029940119,5878948
92111,3525,32425,3551,8584,604600.0,76563.75,34565268,60713,35976,0.0,10.123908758096311,4.188024231127679,7.896687401022024,53761.91578008768,569.3223527086456,0.0987046920169001,0.9012953079831,8561,23,8584,0.9973205964585274,0.0026794035414725,11529069
92113,3117,23003,3179,6853,406600.0,42676.5,16526333,34075,26182,0.0,8.21642025794275,3.8114694294469578,9.527491710894754,38137.567207605,484.99876742479825,0.1214192956993354,0.8785807043006646,6574,279,6853,0.9592879031081278,0.0407120968918721,68699373
92114,6295,55341,6600,14883,461500.0,70853.0,48230175,68574,61941,0.0,9.338787878787878,4.141369347577773,6.513485667508786,41322.08248046151,703.3303438621052,0.1065530101225359,0.8934469898774641,14783,100,14883,0.9932809245447828,0.0067190754552173,31770662
92115,4840,38165,4930,10312,580800.0,54036.5,39048891,81960,43095,0.0,8.723123732251521,4.170384018619084,10.74829050734226,53297.04326822926,476.43839677891657,0.1143984220907297,0.8856015779092702,10265,47,10312,0.9954422032583398,0.0045577967416602,21904502
92116,3036,25880,3127,7126,690400.0,76146.5,29365256,58929,29007,0.0,9.247201790853854,4.057816446814482,9.066733205071802,61421.223072133675,498.3158716421456,0.1078015651394491,0.892198434860551,7035,91,7126,0.987229862475442,0.0127701375245579,32005152
92117,5621,52500,5728,13875,690000.0,88228.25,54826099,86302,58228,0.0,10.146822625698324,4.188900900900901,7.820624346510329,60591.784226406104,635.2819054019606,0.0983719172906505,0.9016280827093496,13846,29,13875,0.99790990990991,0.00209009009009,16503208
92118,1899,17333,2127,4799,1656900.0,108509.5,37361856,39651,19460,0.0,9.04184297132111,4.007501562825588,15.269630769656112,142902.81678543455,942.2676855564804,0.1093011305241521,0.8906988694758479,4796,3,4799,0.9993748697645344,0.0006251302354657,5814498
92119,2775,24952,2853,6525,632500.0,93941.25,30373125,41931,27805,0.0,9.718541885734314,4.249348659003831,6.732931486434341,55238.12499621108,724.3596623023539,0.1026074447041898,0.8973925552958101,6495,30,6525,0.9954022988505749,0.0045977011494252,23900653
92120,3703,32267,3846,8491,654100.0,98971.75,40188867,54498,36113,0.0,9.352574102964118,4.236250147214698,6.608956596200431,56865.455091182885,737.4374655950677,0.1064990446653559,0.893500955334644,8428,63,8491,0.9925803792250618,0.0074196207749381,48365508
92121,397,2824,446,799,821100.0,112457.25,5420113,8666,3270,0.0,7.221973094170403,4.031289111389237,7.301441214328111,70599.89793533052,625.4457650588507,0.1363914373088685,0.8636085626911315,788,11,799,0.986232790988736,0.013767209011264,10375479
92122,2081,20972,2168,5472,780000.0,82389.75,39166420,94021,23140,0.0,10.63330258302583,4.212902046783626,9.467197072451366,68909.36424365152,416.5709788238798,0.0936905790838375,0.9063094209161624,5464,8,5472,0.9985380116959064,0.0014619883040935,7117919
92123,2116,19386,2180,5064,600900.0,87268.0,23046618,48067,21566,0.0,9.863302752293578,4.246050552922591,6.8856854746298755,52818.298242504214,479.4686167224915,0.1010850412686636,0.8989149587313363,5055,9,5064,0.998222748815166,0.0017772511848341,6405818
92124,1993,17701,2191,4651,704400.0,93851.25,27945441,45790,19892,0.0,8.988589685075308,4.234358202537089,7.505494066408279,61522.51797482592,610.29571958943,0.1101447818218379,0.889855218178162,4618,33,4651,0.9929047516663084,0.0070952483336916,27108286
92126,6121,54503,6413,14691,599500.0,98892.25,60766715,107675,60916,0.0,9.45329798846094,4.126608127424954,6.062153505456696,52122.33926524906,564.3530531692594,0.1052761179328912,0.8947238820671088,14634,57,14691,0.9961200735143966,0.0038799264856034,46772854
92127,7041,40911,6827,11490,914200.0,144349.5,78585086,69799,47738,0.0,7.023875787315072,4.1733681462140995,6.333239810321476,76952.90910088703,1125.8769609879798,0.1430097616154845,0.8569902383845155,11405,85,11490,0.9926022628372496,0.0073977371627502,125350302
92128,5793,41888,6017,11293,681900.0,104617.5,68674855,93761,47905,0.0,7.924380920724613,4.222173027539184,6.5180299663058285,58997.759044016086,732.4458463540278,0.1256027554535017,0.8743972445464983,11242,51,11293,0.9954839280970512,0.0045160719029487,62655354
92129,6263,48034,6535,13071,815300.0,126166.5,70424561,74926,54569,0.0,8.308645753634277,4.15400504934588,6.462095722715618,69414.65878656253,939.9215359154366,0.1197566383844307,0.8802433616155693,12861,210,13071,0.9839338994721138,0.0160661005278861,187145651
92130,7877,47084,7563,13217,1189300.0,157229.5,101039012,97231,54647,0.0,7.267089779188153,4.158356661874858,7.5641021564019475,99394.40866041528,1039.164587425821,0.1383973502662543,0.8616026497337457,13126,91,13217,0.9931149277445714,0.0068850722554286,149145416
92131,5020,32885,5370,9075,885500.0,139299.5,64750284,55868,38255,0.0,7.058659217877095,4.176859504132231,6.356806736564022,74761.18484851731,1158.9869692847426,0.140373807345445,0.859626192654555,8723,352,9075,0.9612121212121212,0.0387878787878787,443819344
92139,2638,23987,2755,6321,466100.0,72555.25,24046058,39812,26742,0.0,9.664246823956445,4.212149976269577,6.424069932913194,41645.43287327449,603.9902039586054,0.103021464363174,0.896978535636826,6301,20,6321,0.9968359436797976,0.0031640563202024,11021757
92154,5689,48460,5853,13026,477900.0,69247.75,51811315,85758,54313,0.0,9.25149495984965,4.156993704897896,6.901307262690845,42878.49969326332,604.1572214837099,0.1077642553348185,0.8922357446651814,12995,31,13026,0.9976201443267312,0.0023798556732688,24621828
92173,1001,9178,1123,2455,388700.0,48020.0,8849124,18918,10301,0.0,9.064113980409616,4.146232179226069,8.09454394002499,36059.611695026615,467.7621313035205,0.1090185418891369,0.890981458110863,2435,20,2455,0.9918533604887984,0.0081466395112016,8064253
92201,9454,51856,8543,14886,272400.0,45741.0,52361535,70060,60399,1.8333333333333333,7.176635842209996,4.118634959021899,5.955269889158523,25384.990948623083,747.3813160148444,0.1414427391181973,0.8585572608818027,14862,24,14886,0.9983877468762596,0.0016122531237404,9677617
92203,8296,40141,7252,11937,368900.0,74290.25,46611391,51875,47393,1.8333333333333333,6.679123000551572,4.057719695065762,4.965658346822093,32891.29068115447,898.5328385542168,0.1530183782415124,0.8469816217584876,11928,9,11937,0.9992460417190248,0.0007539582809751,7302255
92210,1937,10413,1842,3299,750700.0,108262.75,43184909,18677,12255,0.0,6.704668838219327,3.7435586541376176,6.9340562658901606,64758.41175157656,2312.197301493816,0.1503059975520196,0.8496940024479804,3295,4,3299,0.9987875113670808,0.001212488632919,5307066
92211,7020,38496,6955,10951,400000.0,66156.5,63742297,73719,45451,0.0,6.544356578001437,4.156332754999544,6.046269074089469,36036.75538732398,864.6657849401104,0.1530219357109854,0.8469780642890146,10949,2,10951,0.9998173682768696,0.0001826317231303,1559740
92220,6410,32903,5857,9782,259600.0,44224.0,31826292,42543,38760,1.8333333333333333,6.712139320471231,4.01891228787569,5.870115774240231,24268.434521817333,748.0970312389817,0.151109391124871,0.848890608875129,9549,233,9782,0.9761807401349416,0.0238192598650582,138361640
92223,12174,61241,10431,18101,354000.0,82469.5,63128655,75129,71672,1.8333333333333333,7.038155498034704,4.0558532677752615,4.292496013677784,31271.577037570012,840.2701353671685,0.1455380064739368,0.8544619935260632,17741,360,18101,0.9801115960444174,0.0198884039555825,282341865
92225,2224,16230,2059,4407,165000.0,44614.25,13491849,19563,18289,1.8333333333333333,8.962603205439533,4.187429090083957,3.6983699154418153,15412.194095927269,689.6615549762306,0.112581333041719,0.887418666958281,4384,23,4407,0.9947810301792602,0.0052189698207397,5667102
92227,2312,19049,2128,5300,226700.0,46336.75,15978615,22235,21177,1.3333333333333333,10.038063909774436,4.030377358490566,4.8924449815751,21100.75644745235,718.624465932089,0.1004863767294706,0.8995136232705293,5277,23,5300,0.9956603773584906,0.0043396226415094,8346824
92230,402,1883,425,571,211900.0,52851.75,1570365,2450,2308,1.8333333333333333,5.376470588235295,4.001751313485114,4.009327978732966,19484.61653066027,640.965306122449,0.1841421143847487,0.8158578856152513,542,29,571,0.9492119089316988,0.0507880910683012,12474242
92231,2747,23953,2889,6650,233300.0,43619.5,22060422,27968,26842,1.3333333333333333,9.241952232606438,4.015037593984962,5.348525315512558,21837.904276051,788.7736699084668,0.1076298338424856,0.8923701661575143,6545,105,6650,0.9842105263157894,0.0157894736842105,22311481
92233,260,2434,302,639,158400.0,38474.25,1892799,2781,2736,1.3333333333333333,8.920529801324504,4.215962441314554,4.117039318505234,15003.204568931898,680.6181229773463,0.1103801169590643,0.8896198830409356,635,4,639,0.9937402190923318,0.0062597809076682,1473391
92234,9754,48626,8590,14335,325200.0,49977.25,53681516,69193,57216,0.0,6.79627473806752,4.072549703522847,6.506960667103532,30057.33302939927,775.82293006518,0.1501328299776286,0.8498671700223713,14314,21,14335,0.998535054063481,0.001464945936519,9201577
92236,3691,24443,3412,6982,262300.0,35892.0,20592282,29001,27855,1.8333333333333333,8.245603751465417,4.029504439988542,7.308035216761395,25008.891580035972,710.0542050274129,0.1224914737031053,0.8775085262968947,6967,15,6982,0.9978516184474364,0.0021483815525637,5686747
92240,7706,34688,7046,10490,230300.0,38934.5,31783407,44647,41734,0.0,6.016747090547828,4.04137273593899,5.915062476723728,21788.829760383003,711.8822541268171,0.1688311688311688,0.8311688311688312,10438,52,10490,0.9950428979980934,0.0049571020019065,16706393
92241,3151,11795,2404,3542,92600.0,32302.75,8692561,13955,14199,0.0,6.217138103161398,4.219649915302089,2.866629002174738,8918.503676129243,622.8993908993192,0.1693076977251919,0.8306923022748081,3522,20,3542,0.994353472614342,0.0056465273856578,8660516
92242,727,4329,593,1168,101600.0,37604.0,3453704,4775,4922,1.7142857142857142,8.526138279932546,4.328767123287672,2.7018402297627913,9644.16660151625,723.2887958115183,0.1204794798862251,0.8795205201137749,1162,6,1168,0.9948630136986302,0.0051369863013698,1300010
92243,4417,32016,4319,8807,216700.0,47860.0,30857829,39724,36335,0.0,8.435517480898357,4.136822981719087,4.527789385708316,20109.43660921624,776.8056842211257,0.1188661070593092,0.8811338929406908,8723,84,8807,0.990462132394686,0.0095378676053139,29082048
92249,538,4738,605,1290,220200.0,51032.5,4356985,5318,5343,1.3333333333333333,8.720661157024793,4.089922480620155,4.314897369323471,20313.24469105994,819.2901466716811,0.113232266516938,0.8867677334830619,1286,4,1290,0.9968992248062016,0.0031007751937984,506296
92250,631,5695,683,1504,234300.0,52426.5,5064630,6451,6378,1.3333333333333333,9.26207906295754,4.2061170212765955,4.469113902320391,21560.356063083946,785.0922337622075,0.1070868610849796,0.8929131389150203,1493,11,1504,0.992686170212766,0.007313829787234,2289329
92251,3187,19671,2662,6061,271600.0,84025.75,19311523,23625,22333,1.3333333333333333,8.586776859504132,3.771324863883847,3.2323424664462976,23952.98601360338,817.418962962963,0.11919580889267,0.88080419110733,6046,15,6061,0.9975251608645438,0.0024748391354561,6545262
92252,2726,13223,2516,3834,217900.0,41841.75,12329708,16598,15739,0.0,6.339030206677266,4.159885237350026,5.207717172441401,20476.1481122656,742.8429931317027,0.1598576783785501,0.8401423216214499,3789,45,3834,0.988262910798122,0.0117370892018779,24070758
92253,11516,58296,11031,17420,453600.0,79931.5,112267567,88716,69327,0.0,6.328709999093464,4.007577497129736,5.6748590981027505,40180.97277390821,1265.4714707606297,0.15911549612705,0.8408845038729499,17410,10,17420,0.9994259471871412,0.0005740528128587,14095257
92254,666,4719,606,1343,160400.0,26043.5,3659114,5494,5325,1.8333333333333333,8.886138613861386,4.009679821295607,6.158926411580625,15775.719629740392,666.0200218420094,0.1138028169014084,0.8861971830985915,1336,7,1343,0.9947877885331348,0.0052122114668652,1931198
92256,971,5081,881,1517,183300.0,47877.75,4970157,6356,5962,0.0,6.869466515323496,3.989452867501648,3.828500712752792,17009.381158706434,781.9630270610447,0.1477692049647769,0.852230795035223,1477,40,1517,0.97363216875412,0.02636783124588,17985968
92260,7924,35421,6173,10532,363400.0,58795.25,69034244,72181,41594,0.0,7.021707435606674,4.115552601595138,6.180771405853364,33091.06512748229,956.4046494229784,0.1484108284848776,0.8515891715151224,10517,15,10532,0.9985757690846944,0.0014242309153057,13840389
92262,6787,29703,6430,8837,447800.0,54341.75,55492039,62723,36133,0.0,5.674961119751166,4.129229376485233,8.240441281335253,41071.08364768636,884.7159574637693,0.177953671159328,0.822046328840672,8823,14,8837,0.99841575195202,0.00158424804798,17242540
92264,4801,21937,4333,6383,386800.0,57102.25,50682262,57857,26270,0.0,6.170782367874452,4.1889393702021,6.7738136413188625,35315.81929399638,875.9918765231519,0.1649409973353635,0.8350590026646365,6372,11,6383,0.998276672411092,0.001723327588908,19464244
92270,5881,25590,4963,8145,570400.0,82489.5,73026043,51733,30553,0.0,6.341124319967761,3.863842848373235,6.914819461870905,50386.79510050849,1411.5949780604255,0.1624390403561025,0.8375609596438975,8135,10,8145,0.9987722529158992,0.0012277470841006,17423753
92274,1756,8156,1571,2752,113200.0,27267.75,7939331,10881,9727,1.8333333333333333,6.309357097390198,3.6017441860465116,4.151424301601709,11083.413495226348,729.6508592960206,0.1615092011925568,0.8384907988074431,2735,17,2752,0.9938226744186046,0.0061773255813953,6828843
92276,2844,9684,1838,3094,206000.0,53043.0,8340665,11338,11522,0.0,6.816104461371055,4.04912734324499,3.883641573817469,18935.810772532855,735.6381195978126,0.1595209165075507,0.8404790834924493,3072,22,3094,0.9928894634776988,0.0071105365223012,3108221
92282,323,1397,322,441,225000.0,39901.75,1738517,1937,1719,0.0,5.341614906832298,3.9002267573696145,5.638850426359746,21238.08509839015,897.5307176045432,0.1873182082606166,0.8126817917393834,394,47,441,0.8934240362811792,0.1065759637188208,15139109
92284,6636,33537,6270,9520,225100.0,45053.25,31208064,41378,39807,0.0,6.407177033492823,4.2198529411764705,4.996309922147681,21006.755715480907,754.2187635941805,0.1575099856809104,0.8424900143190897,9448,72,9520,0.992436974789916,0.007563025210084,26248643
92285,756,3264,691,1043,157100.0,33691.75,3630573,4247,3955,1.7142857142857142,5.817655571635311,3.8542665388302977,4.662862570213776,15069.532396699708,854.8558982811396,0.1747155499367888,0.8252844500632112,991,52,1043,0.950143815915628,0.049856184084372,16194763
92301,5411,26310,5152,7956,238600.0,47424.5,22449041,33026,31462,1.7142857142857142,6.157026397515528,3.987053795877326,5.031154782865396,22160.522284357165,679.738418215951,0.1637530989765431,0.8362469010234569,7853,103,7956,0.9870537958773252,0.0129462041226747,34602715
92307,7551,40812,7176,11597,301700.0,62057.5,45123147,51145,47988,0.0,6.739548494983278,4.170302664482194,4.861620271522378,27338.25773570949,882.2592042232867,0.1495373843460865,0.8504626156539135,11541,56,11597,0.9951711649564544,0.0048288350435457,25507323
92308,8668,47002,8164,13343,282100.0,53357.75,46123338,58348,55166,0.0,6.818961293483587,4.172225136775838,5.286954566112701,25916.935592531343,790.4870432576952,0.1479897038030671,0.8520102961969329,13269,74,13343,0.9944540208348946,0.0055459791651052,33595497
92311,4814,27284,4637,7720,144900.0,45456.25,23095056,35838,31921,1.7142857142857142,6.922147940478758,4.157772020725389,3.1876804619826755,13511.112339506648,644.4292650259501,0.1452648726543654,0.8547351273456345,7665,55,7720,0.9928756476683938,0.0071243523316062,15502875
92313,1549,11051,1439,3034,378100.0,71499.0,12413903,17287,12490,0.0,8.756080611535788,4.152933421226104,5.2881858487531295,33827.06975256963,718.1062648232776,0.1152121697357886,0.8847878302642114,3010,24,3034,0.992089650626236,0.007910349373764,18007513
92314,5533,23730,6443,8148,307100.0,55712.5,35700959,37212,30173,0.0,4.541828340835015,3.5914334806087385,5.5122279560242315,28102.22631996701,959.3937170805116,0.2135352798859907,0.7864647201140093,4148,4000,8148,0.5090819833087874,0.4909180166912125,2203838757
92315,5332,20755,6134,8060,467800.0,56211.5,38889025,34832,26889,0.0,4.252852950766221,3.236600496277916,8.322140487266841,42772.72345142904,1116.474075562701,0.2281230242850236,0.7718769757149764,3737,4323,8060,0.4636476426799007,0.5363523573200992,2837908126
92316,3029,20282,3017,5651,339100.0,61373.25,17278035,24298,23299,1.7142857142857142,7.726549552535632,4.125110599893824,5.525208458082308,30758.124684062062,711.088772738497,0.1294905360745096,0.8705094639254903,5525,126,5651,0.977703061405061,0.0222969385949389,48280356
92320,3125,11800,2398,4095,279200.0,59484.0,11633858,14963,14198,1.8333333333333333,6.223936613844871,3.6446886446886446,4.6936991459888375,25396.91168693382,777.5083873554769,0.1688970277503873,0.8311029722496126,3942,153,4095,0.9626373626373628,0.0373626373626373,99935788
92321,203,1055,310,356,370900.0,50488.25,2083221,1755,1365,0.0,4.058064516129032,3.533707865168539,7.346263734631325,34249.05488803816,1187.0205128205127,0.2271062271062271,0.7728937728937729,115,241,356,0.3230337078651685,0.6769662921348315,122203647
92325,3786,12450,4001,5160,278800.0,62519.0,25972860,24578,16451,1.7142857142857142,4.057985503624094,3.146511627906977,4.459444328924007,25246.24646038052,1056.7523801773943,0.2432070998723481,0.7567929001276518,1269,3891,5160,0.2459302325581395,0.7540697674418605,2017761636
92335,7132,52362,7129,14432,344200.0,56711.25,39241423,67424,59491,1.7142857142857142,8.345349978959181,4.122366962305986,6.069342502589874,31446.058561621765,582.0097146416706,0.1198332520885512,0.8801667479114488,14166,266,14432,0.9815687361419068,0.0184312638580931,91040313
92336,15544,86680,13610,25741,460100.0,95597.0,92693698,107965,100290,1.7142857142857142,7.510947832476121,3.971252088108465,4.812912539096415,40120.69617666626,858.5532163201037,0.1357064512912553,0.8642935487087446,25577,164,25741,0.9936288411483626,0.0063711588516374,99084309
92337,4578,30030,4727,8141,403600.0,83695.5,28851576,36594,34757,1.7142857142857142,7.321345462238206,4.251074806534824,4.822242533947464,35606.71538588162,788.4236760124611,0.1360013810167736,0.8639986189832264,8042,99,8141,0.9878393317774228,0.012160668222577,49034114
92339,313,1656,339,607,335700.0,68843.25,3113458,3005,1995,0.0,5.808259587020649,3.243822075782537,4.8762950616073475,30135.765907073634,1036.092512479201,0.1699248120300752,0.8300751879699249,230,377,607,0.3789126853377265,0.6210873146622735,195856991
92342,1820,9359,1787,2582,266100.0,75474.25,10858155,12346,11146,1.7142857142857142,6.255735870173475,4.329589465530597,3.5257057870730746,23692.195235862306,879.4876883201036,0.1603265745558945,0.8396734254441055,2566,16,2582,0.9938032532920216,0.0061967467079783,5836372
92344,4315,20163,4200,6065,345700.0,86419.75,24814159,25739,24363,1.7142857142857142,5.828095238095238,4.035943940643034,4.000243000008679,30412.674078944437,964.0684952795368,0.1723925624923039,0.827607437507696,5723,342,6065,0.94361088211047,0.05638911788953,239742223
92345,13364,75035,12529,21452,277100.0,52136.75,69036021,95890,87564,1.7142857142857142,7.055551121398356,4.120781279134812,5.314869070281519,25511.8355665089,719.9501616435499,0.1430839157644694,0.8569160842355306,21261,191,21452,0.9910964012679472,0.0089035987320529,89974573
92346,7213,49025,6998,13494,367300.0,67693.75,54618388,62546,56023,1.7142857142857142,8.036296084595598,4.167630057803469,5.425907118456283,33022.41159291536,873.2514948997538,0.1249129821680381,0.8750870178319619,13349,145,13494,0.9892544834741368,0.0107455165258633,130998656
92352,5875,19775,6577,8327,457800.0,87099.25,60032896,36678,26352,0.0,3.899954386498403,3.080341059204996,5.256072813485765,40246.84891538636,1636.7548939418723,0.2495825743776563,0.7504174256223437,2455,5872,8327,0.2948240662903807,0.7051759337096193,5116111492
92354,2570,16614,2337,4824,411400.0,59950.25,18695063,28114,18951,0.0,8.208814719726144,3.976782752902156,6.862356704100483,37395.68137473295,664.9734296080245,0.1233180307107804,0.8766819692892196,4784,40,4824,0.9917081260364844,0.0082918739635157,26647785
92356,1171,5587,1154,1605,169100.0,33735.5,5428064,7109,6741,0.0,5.856152512998267,4.210591900311527,5.012523899156674,16218.591744376708,763.5481783654523,0.1711912179201898,0.8288087820798101,1554,51,1605,0.9682242990654204,0.0317757009345794,20358056
92358,134,644,138,302,418800.0,47549.25,1542496,1433,782,0.0,5.63768115942029,2.576158940397351,8.807709900787078,38887.5223446816,1076.4103279832518,0.1764705882352941,0.8235294117647058,125,177,302,0.4139072847682119,0.5860927152317881,80156432
92359,1296,8049,1186,2355,341600.0,62199.75,8472611,10981,9235,1.7142857142857142,7.879426644182125,3.968152866242038,5.491983488679617,30947.33752071576,771.5700755851016,0.1284244721169464,0.8715755278830536,2235,120,2355,0.9490445859872612,0.0509554140127388,68212493
92363,1367,7831,1216,2319,125400.0,33161.75,6970379,9266,9047,1.7142857142857142,7.564144736842105,3.966364812419146,3.781465091558799,12047.090425290487,752.2532916037125,0.1344091964187023,0.8655908035812977,2309,10,2319,0.9956877964639932,0.0043122035360068,2753517
92365,358,2276,352,657,117600.0,55148.0,2433589,2805,2628,0.0,7.482954545454546,4.0091324200913245,2.132443606295786,10771.424747382,867.5896613190731,0.1339421613394216,0.8660578386605784,643,14,657,0.9786910197869102,0.0213089802130898,6855429
92368,131,508,133,166,259800.0,35371.75,579536,754,641,0.0,4.804511278195489,3.8493975903614457,7.344844402665969,24805.06172235112,768.6153846153846,0.2074882995319812,0.7925117004680188,162,4,166,0.9759036144578314,0.0240963855421686,1043411
92371,3183,15584,3100,4624,272700.0,59648.25,20292818,20447,18684,1.7142857142857142,6.053870967741935,4.0586072664359865,4.571802190340874,24799.430875847615,992.459431701472,0.1659173624491543,0.8340826375508457,4296,328,4624,0.9290657439446368,0.0709342560553633,143156475
92372,1431,6490,1350,1973,294100.0,55124.75,8297049,8333,7840,0.0,5.867407407407407,4.0146984287886465,5.335171588079764,26938.761710006092,995.6857074282972,0.1721938775510204,0.8278061224489796,1838,135,1973,0.9315762797769892,0.0684237202230106,75097823
92374,5620,37678,5026,10566,413600.0,76716.25,38145648,52883,42704,1.7142857142857142,8.614803024273776,4.097861063789513,5.391295846707836,36771.41032457522,721.3215589130723,0.1176938928437617,0.8823061071562383,10499,67,10566,0.993658905924664,0.0063410940753359,56798410
92376,7751,52882,7427,14937,332100.0,58131.25,45351373,68680,60309,1.7142857142857142,8.163861586104753,4.059248845149629,5.7129340931082675,30272.207404607307,660.3286691904484,0.1231491153890795,0.8768508846109204,14707,230,14937,0.9846019950458592,0.0153980049541407,90264769
92377,2817,18886,2824,5229,418300.0,91686.5,21371380,22439,21710,1.7142857142857142,7.685198300283286,4.150506789061006,4.56228561456703,36609.06924072228,952.4212308926424,0.1300783049286043,0.8699216950713957,5185,44,5229,0.9915853891757508,0.0084146108242493,22577915
92382,2307,8923,2408,3367,296600.0,63791.25,16990012,16065,11331,0.0,4.663621262458472,3.3353133353133355,4.649540493406227,26809.18787046597,1057.5793339558045,0.2125143411878916,0.7874856588121084,1148,2219,3367,0.340956340956341,0.659043659043659,1184110623
92386,1661,7320,1994,2459,304800.0,40375.0,8683656,11352,9314,1.7142857142857142,4.504012036108325,3.6522976819845465,7.54922600619195,28738.541898078965,764.9450317124736,0.2140863216663087,0.7859136783336912,1068,1391,2459,0.4343228954859699,0.5656771045140301,532407406
92391,858,2746,936,1138,277100.0,52792.75,5839168,5349,3682,0.0,3.8504273504273505,3.1669595782073814,5.248826780192356,25482.500362675542,1091.6373153860534,0.2542096686583379,0.7457903313416622,312,826,1138,0.2741652021089631,0.7258347978910369,447121185
92392,10229,56436,9762,16308,276900.0,62406.5,54026077,72359,66198,1.7142857142857142,6.829030936283549,4.087870983566348,4.437037808561608,25078.285378226457,746.6393537776918,0.1474666908365811,0.8525333091634189,16201,107,16308,0.993438803041452,0.0065611969585479,42842115
92394,5991,29973,5554,8918,261300.0,59195.0,26093408,37393,35527,1.7142857142857142,6.475333093266115,4.032742767436645,4.414224174339049,23779.205879216606,697.8153130265023,0.1563318039800715,0.8436681960199285,8853,65,8918,0.9927113702623906,0.0072886297376093,26433272
92395,7718,36284,6945,10942,255100.0,49260.75,32983309,50096,43229,1.7142857142857142,6.335781137509,4.021385487113873,5.178565084778449,23609.695952682796,658.40204806771,0.1606560410835318,0.8393439589164681,10844,98,10942,0.9910436848839336,0.0089563151160665,36057592
92399,8772,53953,8629,15181,368400.0,70921.75,63023000,69611,62582,1.7142857142857142,7.269092594738672,4.1318094987155,5.194457271570428,32983.17084973101,905.3597850914368,0.1378830973762423,0.8621169026237576,14296,885,15181,0.9417034450958436,0.0582965549041565,757802773
92401,110,639,123,219,264300.0,29657.25,541746,1177,762,0.0,6.0894308943089435,3.4200913242009134,8.911817515110133,25666.51886867644,460.2769753610875,0.1614173228346456,0.8385826771653543,205,14,219,0.9360730593607306,0.0639269406392694,3328947
92404,6676,38377,6527,10932,289900.0,49106.0,35647158,51967,44904,0.0,6.902558602727133,4.121203805342115,5.903555573656987,26838.277330816087,685.9575884696058,0.1453545341172278,0.8546454658827721,10593,339,10932,0.9689901207464324,0.0310098792535675,132301967
92405,3810,21088,3785,6088,277800.0,42203.0,18384704,28316,24873,0.0,6.578071334214003,4.089684625492772,6.582470440490012,26083.903101819476,649.2691058059048,0.1521730390383146,0.8478269609616854,5845,243,6088,0.9600854139290408,0.0399145860709592,76936171
92407,8387,46143,7796,13355,367300.0,70119.0,47945798,63147,53939,0.0,6.994612621857363,4.083114938225384,5.238237852793109,32918.235909066876,759.2727762205648,0.1445336398524259,0.8554663601475742,12823,532,13355,0.9601647323099962,0.0398352676900037,265855791
92408,1243,7000,1409,2103,304900.0,48986.75,5620801,10064,8409,0.0,5.850248403122782,3.9196386115073705,6.224132035703532,28233.2980004701,558.5056637519873,0.1675585682007373,0.8324414317992627,2031,72,2103,0.9657631954350928,0.0342368045649072,17857763
92410,4193,22285,3892,6973,207500.0,38057.75,16977225,31085,26177,0.0,6.803186022610483,3.797217840240929,5.452240345264762,19674.102014131066,546.1548978607045,0.1486801390533674,0.8513198609466326,6649,324,6973,0.953535063817582,0.0464649361824179,83904000
92411,2661,14386,2513,4314,238400.0,44733.25,10673383,18820,16899,0.0,6.783525666534023,3.951553082985628,5.3293690934595634,22262.74599816235,567.1298087141339,0.1487070240842653,0.8512929759157346,4106,208,4314,0.951784886416319,0.048215113583681,63359535
92501,2515,15599,2372,4409,358700.0,65263.25,14821458,21999,17971,1.8333333333333333,7.636593591905565,4.108414606486732,5.496201920682773,32355.586740938696,673.7332606027546,0.1319904290245395,0.8680095709754605,4385,24,4409,0.9945565887956452,0.0054434112043547,11884509
92503,11410,67872,10834,19212,426000.0,73532.5,70980397,91005,78706,1.8333333333333333,7.317888129961233,4.126691651051426,5.793356679019481,38017.10367675356,779.961507609472,0.1376515132264376,0.8623484867735624,19009,203,19212,0.989433687278784,0.0105663127212159,138370616
92504,6686,43480,6492,11957,391600.0,67241.0,46155186,59127,49972,1.8333333333333333,7.72735674676525,4.195533996821945,5.823827724156392,35228.377575907994,780.61098990309,0.1299127511406387,0.8700872488593613,11879,78,11957,0.9934766245713808,0.0065233754286192,51148791
92505,4931,32256,4814,8994,408100.0,69804.75,31550975,51845,37070,1.8333333333333333,7.724761113419194,4.134645319101623,5.846307020654039,36589.55135007285,608.5635066062301,0.1298624224440248,0.8701375775559752,8944,50,8994,0.9944407382699576,0.0055592617300422,22750383
92506,7012,50906,7015,13607,503700.0,99520.5,66138283,63603,57921,1.8333333333333333,8.256307911617961,4.256485632395091,5.061268783818409,43769.09927443105,1039.8610600128925,0.1211132404481966,0.8788867595518033,13554,53,13607,0.9961049459836848,0.0038950540163151,52964488
92507,5518,30125,4713,9509,396100.0,54067.75,31196979,62841,34838,1.8333333333333333,7.562698917886697,3.7483436744137135,7.325993776326923,36346.14133678387,496.4430706067695,0.1352833113267122,0.8647166886732878,9430,79,9509,0.9916920811862446,0.0083079188137553,38069401
92508,5540,33131,5497,9155,536600.0,118114.75,44954661,42394,38628,1.8333333333333333,7.034928142623249,4.22403058438012,4.543039713498949,45944.09419932529,1060.4014954946454,0.1423060992026509,0.8576939007973491,9129,26,9155,0.9971600218459858,0.0028399781540141,16630788
92509,9196,56208,8679,16183,391900.0,73189.25,53818538,70465,64887,1.8333333333333333,7.535891231708722,4.041525057158747,5.354611503738595,34988.56027697892,763.7626906975094,0.1337556058994868,0.8662443941005132,15948,235,16183,0.9854785886424026,0.0145214113575974,111364665
92532,5632,23203,5712,6825,413400.0,89964.25,30590632,31962,28915,0.0,5.048144257703081,4.224908424908425,4.595158632456782,36240.37208448348,957.0937988861772,0.1975445270620785,0.8024554729379215,6597,228,6825,0.9665934065934066,0.0334065934065934,172133461
92536,635,3759,703,1149,374100.0,56689.5,6215039,4943,4462,1.8333333333333333,6.250355618776672,3.824194952132289,6.599105654486281,34178.915726870066,1257.3414930204328,0.1575526669654863,0.8424473330345137,902,247,1149,0.7850304612706701,0.2149695387293298,142117650
92539,540,3649,724,1122,242300.0,46804.25,6193194,5150,4373,1.8333333333333333,5.785911602209945,3.733511586452763,5.176880304673187,22531.718390101774,1202.5619417475727,0.1655613994969128,0.8344386005030872,765,357,1122,0.6818181818181818,0.3181818181818182,151270089
92543,6372,27896,5879,8531,169000.0,36757.0,22514959,40116,33775,1.8333333333333333,5.828882463003913,4.016879615519868,4.59776369126969,16076.736125755086,561.2463605543923,0.1740636565507032,0.8259363434492968,8438,93,8531,0.989098581643418,0.0109014183565818,32824574
92544,8589,42759,8479,12528,271700.0,53575.75,45092267,55684,51238,1.8333333333333333,6.055902818728623,4.0986590038314175,5.071324246510781,24952.12576207176,809.7885748150277,0.1654826495960029,0.834517350403997,12098,430,12528,0.965676883780332,0.0343231162196679,274701421
92545,10062,47197,9729,13649,252000.0,47831.0,42339899,62975,56926,1.8333333333333333,5.885394182341454,4.195105868561799,5.2685496853505045,23386.539347762176,672.3286859865026,0.1709060886062607,0.8290939113937392,13524,125,13649,0.9908418199135468,0.0091581800864532,72882225
92548,1130,5378,1110,1606,192700.0,50817.0,5343946,6912,6488,1.8333333333333333,5.863063063063063,4.052303860523039,3.7920380974870618,17783.337485835626,773.1403356481482,0.1710850801479654,0.8289149198520345,1499,107,1606,0.9333748443337484,0.0666251556662515,43125854
92549,1969,9664,2138,3577,400300.0,74992.0,19103387,16695,11802,1.8333333333333333,5.441066417212348,3.2521666200726864,5.33790270962236,35661.03558284371,1144.2579814315663,0.1811557363158786,0.8188442636841213,1291,2286,3577,0.360916969527537,0.639083030472463,1388331554
92551,4339,24114,4148,6997,332400.0,70135.5,22493975,31715,28262,0.0,6.859450337512054,4.066457053022724,4.739397309493766,29789.792778956675,709.2535078038783,0.1467695138348312,0.8532304861651688,6938,59,6997,0.991567814777762,0.0084321852222381,25783272
92553,7682,48005,7679,13678,321800.0,54114.25,39660761,65313,55684,0.0,7.251855710378956,4.071282351220939,5.94667763112304,29526.043243471115,607.2414526970128,0.1379031678758709,0.862096832124129,13556,122,13678,0.9910805673344056,0.0089194326655943,50043648
92555,6928,36458,6405,10429,403300.0,90487.75,42212757,47334,42863,0.0,6.773770491803279,4.160130405599769,4.4569568809037685,35336.9901463903,891.8062492077577,0.1494295779576791,0.8505704220423209,10308,121,10429,0.988397737079298,0.0116022629207018,79452503
92557,8301,45037,7881,12798,362200.0,74975.5,46123452,61245,52918,0.0,6.767922852429895,4.167682450382872,4.830911431067482,32267.500113194877,753.0974283614989,0.1489285309346536,0.8510714690653464,12637,161,12798,0.9874199093608376,0.0125800906391623,109167111
92561,535,2600,614,770,369100.0,66663.25,4658221,3241,3214,0.0,5.105863192182411,4.071428571428571,5.536783760167709,33230.07161189507,1437.278926257328,0.1910392034847542,0.8089607965152458,575,195,770,0.7467532467532467,0.2532467532467532,172216552
92562,11701,58508,11671,17002,478500.0,94479.5,97395068,91596,70179,1.8333333333333333,6.01567989032645,4.1294553581931535,5.064590731322668,41768.0018667796,1063.311367308616,0.166303310107012,0.833696689892988,16281,721,17002,0.9575932243265498,0.0424067756734501,1036825596
92563,14156,65262,13056,19200,459800.0,97386.25,83218449,92919,78318,1.8333333333333333,6.082873774509804,4.136354166666667,4.721405742597133,40029.80798414697,895.6020727730604,0.1667049720370796,0.8332950279629204,19104,96,19200,0.995,0.005,79899456
92567,1560,7836,1511,2326,379400.0,75845.5,9437122,9822,9347,1.8333333333333333,6.218398411647915,4.039552880481513,5.002274360377346,33765.10166246173,960.8147016900834,0.1616561463571199,0.8383438536428801,2218,108,2326,0.9535683576956148,0.0464316423043852,54481884
92570,7056,34229,6711,10492,326200.0,61045.75,38398172,44524,40940,1.8333333333333333,6.151840262255997,3.9349027830728174,5.343533333606352,29602.394480103547,862.4151468870722,0.1639228138739619,0.8360771861260381,9802,690,10492,0.9342356080823484,0.0657643919176515,346388677
92571,7722,40419,7650,11663,336100.0,67208.25,37681578,49714,48069,1.8333333333333333,6.292941176470588,4.127668695875847,5.0008741486350266,30236.916849830803,757.9671319950114,0.1591462272982587,0.8408537727017412,11508,155,11663,0.986710108891366,0.0132898911086341,68582481
92582,4091,17234,3341,5340,339000.0,73183.25,17258548,21482,20575,0.0,6.382819515115235,3.993445692883895,4.632207506499096,30265.90648186795,803.3957732054744,0.1623815309842041,0.8376184690157958,5283,57,5340,0.9893258426966292,0.0106741573033707,40989327
92583,5113,25618,4893,7449,251700.0,46344.5,21563695,32922,30511,0.0,6.280604945840997,4.125520204054236,5.431065174939852,23427.338885642148,654.9934694125509,0.1603683917275736,0.8396316082724263,7373,76,7449,0.9897972882266076,0.0102027117733924,29494946
92584,13650,54970,10973,17818,422000.0,96239.75,63344299,71705,65943,1.8333333333333333,6.253531395242869,3.851161746548434,4.384882545933463,36776.888313202384,883.4014224949445,0.1664012859590858,0.8335987140409141,17653,165,17818,0.9907397014255248,0.0092602985744752,88156184
92585,5519,23824,4529,7699,371400.0,79605.25,24834404,30813,28353,0.0,6.478913667476264,3.8112741914534354,4.665521432317592,32911.423988255025,805.9716353487164,0.159736183119952,0.8402638168800479,7658,41,7699,0.9946746330692298,0.0053253669307702,23346757
92586,6788,31422,6398,8952,276200.0,43909.25,26419999,42478,37820,0.0,5.972178805876837,4.268319928507596,6.290246360391034,25837.520410660545,621.9689957154292,0.169169751454257,0.8308302485457429,8934,18,8952,0.9979892761394102,0.0020107238605898,9907787
92587,4798,20439,4609,6028,442700.0,86967.5,27073630,26695,25048,0.0,5.475591234541115,4.186629064366291,5.090407336073821,38924.53363642491,1014.1835549728412,0.1840067071223251,0.8159932928776749,5923,105,6028,0.9825812873258128,0.0174187126741871,50632785
92590,483,2531,538,781,1071800.0,67079.25,8727231,5968,3069,1.8333333333333333,5.602230483271375,3.859154929577465,15.978115438082568,96440.13671552888,1462.337634048257,0.1753014011078527,0.8246985988921472,537,244,781,0.6875800256081946,0.3124199743918053,388156561
92591,6936,37337,6665,10751,501600.0,88885.5,46875566,59571,44002,1.8333333333333333,6.642610652663166,4.118035531578458,5.643215147577501,44018.903788542,786.8856658441188,0.1514703877096495,0.8485296122903504,10722,29,10751,0.9973025765045112,0.0026974234954887,31129902
92592,14465,79554,14607,22219,522400.0,107412.0,113663408,110314,94161,1.8333333333333333,6.436571506811802,4.231468562941626,4.863516180687446,45095.02210015317,1030.3624925213485,0.1551279192022174,0.8448720807977825,21813,406,22219,0.9817273504658176,0.0182726495341824,496343381
92595,6507,30961,6192,9003,417300.0,79121.5,40302402,42335,37153,1.8333333333333333,6.051033591731266,4.161723869821171,5.274166945773273,36998.81394441742,951.9877642612496,0.1666621807121901,0.8333378192878099,8713,290,9003,0.9677885149394646,0.0322114850605353,159576937
92596,7079,28031,5670,9390,475400.0,103331.25,35954912,37102,33701,1.8333333333333333,6.192239858906525,3.7390841320553783,4.600737918103188,41175.51994917118,969.0828526764057,0.1682442657487908,0.8317557342512092,9332,58,9390,0.9938232161874334,0.0061767838125665,35522978
92602,4215,18090,3032,5778,933600.0,107773.0,29090683,44194,21122,0.0,7.356530343007916,3.8603322949117342,8.662652055709685,80567.61547359599,658.2496040186451,0.1435470125935044,0.8564529874064956,5755,23,5778,0.9960193838698512,0.0039806161301488,24707263
92603,2398,15924,2313,4135,1303200.0,155873.5,38842800,33314,18237,0.0,7.921314310419369,4.430955259975816,8.36062576384055,108992.37199567028,1165.9602569490305,0.1268300707353183,0.8731699292646817,4115,20,4135,0.9951632406287788,0.0048367593712212,42284308
92604,1979,18321,1929,4663,818400.0,109761.75,25015050,41172,20250,0.0,10.523587350959046,4.353420544713703,7.456149341642239,70514.84130939399,607.5743223549986,0.0952592592592592,0.9047407407407408,4660,3,4663,0.999356637357924,0.0006433626420759,4076873
92606,1443,12248,1456,3196,853800.0,109213.25,17333232,35616,13704,0.0,9.40315934065934,4.283792240300375,7.817732738472667,73596.7378272731,486.6698113207547,0.1062463514302393,0.8937536485697607,3195,1,3196,0.9996871088861076,0.0003128911138923,3392853
92610,1981,10268,1735,3037,807300.0,139461.25,17324492,18817,12003,0.0,7.059942363112392,4.033256503128087,5.788704747734585,68152.22094915928,920.6829994154224,0.1445471965341997,0.8554528034658002,2996,41,3037,0.986499835363846,0.0135001646361541,47803972
92612,996,6597,989,1575,789000.0,78657.0,21525068,60467,7586,0.0,7.6774519716885745,4.820952380952381,10.03089362675922,69991.1616464805,355.9804190715597,0.1303717374110203,0.8696282625889797,1574,1,1575,0.9993650793650792,0.0006349206349206,1171100
92614,1368,12229,1368,3106,789500.0,103599.0,21278961,47501,13597,0.0,9.939327485380115,4.37765614938828,7.620729929825577,68365.14163974742,447.9686953958864,0.1006104287710524,0.8993895712289476,3102,4,3106,0.9987121699935608,0.0012878300064391,2666705
92617,462,3604,351,993,585600.0,44021.75,5317046,8327,3955,0.0,11.584045584045583,4.094662638469285,13.302515233946856,54767.672187160824,638.5308034105921,0.088748419721871,0.9112515802781288,993,0,993,1.0,0.0,10000
92618,9436,27339,5920,9806,960800.0,109765.5,45772283,94140,33259,0.0,6.211993243243243,3.7502549459514585,8.753205697600794,82784.04215017607,486.21503080518374,0.1779969331609489,0.8220030668390511,9789,17,9806,0.9982663675300836,0.0017336324699163,22533535
92620,8101,44772,7127,12182,982000.0,118620.0,59762577,94362,51899,0.0,7.418689490669286,4.340256115580364,8.278536503119204,84048.85854526845,633.333089591149,0.1373244185822462,0.8626755814177537,12171,11,12182,0.9990970284025612,0.0009029715974388,15968448
92624,1145,8166,1172,2259,913400.0,105764.5,13477462,12129,9338,0.0,7.944539249146757,4.1217352810978305,8.636168090427317,78952.57606728445,1111.1766839805423,0.1255086742343114,0.8744913257656886,2255,4,2259,0.9982293050022134,0.0017706949977866,1421714
92625,2359,16946,2334,4430,2000001.0,156444.75,44006226,27422,19280,0.0,8.271208226221079,4.357787810383747,12.78407233224509,167217.75771295495,1604.7781343446868,0.121058091286307,0.8789419087136929,4423,7,4430,0.9984198645598196,0.0015801354401805,8489476
92626,3839,33117,3729,8821,842500.0,91826.75,43509117,73200,36846,0.0,9.910431751139717,4.1895476703321615,9.174886402927251,73724.63645192178,594.3868442622951,0.1012050154697932,0.8987949845302068,8817,4,8821,0.9995465366738464,0.0004534633261534,3065283
92627,4478,35400,4137,9762,842100.0,82996.0,40847194,73371,39537,0.0,9.639352187575538,4.085023560745749,10.146272109499254,74347.45545033606,556.7212386365185,0.1046361635935958,0.8953638364064042,9748,14,9762,0.9985658676500716,0.0014341323499282,4121288
92629,3568,26707,3435,7237,981600.0,104062.5,56612168,52206,30142,0.0,8.8136826783115,4.183363272074064,9.432792792792792,84966.8051650666,1084.39964755009,0.1139605865569637,0.8860394134430363,7229,8,7237,0.9988945695730276,0.0011054304269725,18360769
92630,7772,51608,6944,14114,694800.0,99658.5,74371514,93766,58552,0.0,8.551267281105991,4.207170185631288,6.971808726802029,60367.49824658488,793.1607832263294,0.1185954365350457,0.8814045634649542,14090,24,14114,0.9982995607198526,0.0017004392801473,19878061
92637,414,2808,400,545,327000.0,46401.5,19282275,45311,3208,0.0,8.055,5.911926605504587,7.047185974591339,30432.51283246246,425.55394937211713,0.1246882793017456,0.8753117206982544,545,0,545,1.0,0.0,314218
92646,5922,57397,5609,14934,814900.0,102799.0,72941240,91512,63006,0.0,11.288821536815831,4.23992232489621,7.927119913617837,70612.00275407523,797.0674884168196,0.0890232676253055,0.9109767323746945,14923,11,14934,0.9992634257399224,0.0007365742600776,10466746
92647,4561,43008,4355,11465,793300.0,89130.5,44486823,79273,47363,0.0,10.92284730195178,4.1490623637156565,8.90043251187865,69600.80384096674,561.1850567027866,0.0919494119882608,0.9080505880117392,11451,14,11465,0.9987788922808548,0.0012211077191452,5871478
92648,4193,33711,3977,9003,985800.0,98124.75,58912770,76820,37688,0.0,9.530802112144832,4.21015217149839,10.04639502266248,85766.52486360344,766.8936474876334,0.1055243048185098,0.8944756951814902,8997,6,9003,0.9993335554815062,0.0006664445184938,8208681
92649,3703,31566,3391,8369,885000.0,100896.5,47668195,58346,34957,0.0,10.40076673547626,4.2142430397897,8.771364715327092,76810.57818123567,816.9916532410106,0.0970048917241182,0.9029951082758818,8363,6,8369,0.9992830684669614,0.0007169315330385,8152578
92651,4397,32870,4425,9219,2000001.0,131647.25,89710155,51258,37295,0.0,8.421920903954803,4.0424124091550055,15.192121369796938,169665.85878959633,1750.1688516914433,0.1186486124145327,0.8813513875854673,8760,459,9219,0.9502115196876016,0.0497884803123983,651571520
92653,3430,23655,3367,6279,771800.0,104123.75,49450262,43041,27022,0.0,8.044253044253045,4.313584965758879,7.412333881559203,66803.21958774995,1148.91062010641,0.1246021760047368,0.8753978239952631,6266,13,6279,0.9979296066252588,0.0020703933747412,16416587
92655,839,4927,793,1409,583300.0,43183.0,3679880,7531,5720,0.0,7.271122320302648,4.092264017033357,13.507630317486049,54650.89016938513,488.63099190014606,0.1386363636363636,0.8613636363636363,1408,1,1409,0.9992902767920512,0.0007097232079489,275453
92656,4288,28422,4389,7574,679300.0,114400.75,55989640,87669,32811,0.0,7.45272271588061,4.31872194349089,5.9378981344090835,58321.71392382979,638.6480968187159,0.133766115022401,0.866233884977599,7537,37,7574,0.9951148666490626,0.0048851333509374,32471617
92657,1930,11645,1983,3233,2000001.0,194387.75,51660187,20023,13628,0.0,6.845688350983359,4.198886483142592,10.288719325163235,164235.91941324223,2580.0423013534437,0.145509245670678,0.854490754329322,3133,100,3233,0.9690689761831116,0.0309310238168883,212634122
92660,3891,26680,3757,7224,1905400.0,131012.5,79308076,67539,30437,0.0,8.137077455416556,4.231866002214839,14.543650415036732,161706.8857882627,1174.2560002369005,0.1234352925715412,0.8765647074284588,7209,15,7224,0.9979235880398672,0.0020764119601328,29486707
92661,803,5685,804,1687,2000001.0,142870.25,14014128,8728,6489,0.0,8.069651741293532,3.84588026081802,13.998722617199872,168496.45078689215,1605.6516956920257,0.1239019879796578,0.8760980120203421,1683,4,1687,0.997628927089508,0.0023710729104919,4794574
92662,614,4738,626,1368,2000001.0,123834.0,9368202,6827,5364,0.0,8.549520766773163,3.912280701754386,16.150661369252386,170551.09033707075,1372.2282115131095,0.116703952274422,0.8832960477255779,1367,1,1368,0.9992690058479532,0.0007309941520467,414335
92663,2772,19559,2597,5489,1590000.0,108854.5,43681146,41769,22156,0.0,8.598767809010397,4.068318455092002,14.606653836083948,137095.35156103747,1045.7790706026,0.1172142986098573,0.8827857013901427,5479,10,5489,0.99817817453088,0.00182182546912,9912034
92672,4565,31942,4279,8938,980200.0,88690.0,55623979,63119,36221,0.0,8.531666277167563,4.084470798836429,11.051978802570751,86036.0216967479,881.2557074731856,0.1181358880207614,0.8818641119792385,8901,37,8938,0.9958603714477512,0.0041396285522488,47596661
92675,4932,30203,4445,8473,770000.0,100130.0,61440720,47008,34648,0.0,7.9043869516310465,4.146701286439278,7.690002996105063,66873.80395685426,1307.0268890401633,0.1282902332024936,0.8717097667975063,8415,58,8473,0.9931547267791808,0.006845273220819,84637522
92676,373,1599,353,706,712200.0,105897.75,5639379,3909,1952,0.0,5.586402266288951,2.7932011331444757,6.725355354575522,61554.527785302744,1442.6653875671527,0.1808401639344262,0.8191598360655737,156,550,706,0.2209631728045325,0.7790368271954674,448250330
92677,8046,56585,8077,14973,909500.0,114097.75,117028824,112066,64662,0.0,8.001857125170236,4.316503038803179,7.971235190877997,78103.45864456966,1044.2848321524816,0.124911076057035,0.875088923942965,14861,112,14973,0.9925198690977092,0.0074801309022907,149213553
92679,6498,30951,6655,9071,970200.0,179570.5,81174447,46441,37606,0.0,5.627197595792637,4.128431264469188,5.402891900395666,80192.9314146075,1747.9048039447905,0.1769664415252885,0.8230335584747115,8019,1052,9071,0.88402601697718,0.1159739830228199,1517030588
92683,7918,62355,7250,16857,651200.0,65660.5,53601905,92098,69605,0.0,9.692827586206896,4.16877261671709,9.917682625018086,58707.641395172475,582.0094356012074,0.104159183966669,0.895840816033331,16837,20,16857,0.9988135492673668,0.0011864507326333,9914300
92688,4415,29336,4557,7924,673400.0,117254.75,53017448,65889,33893,0.0,7.406407724380075,4.259338717819283,5.743050921178034,57693.110738394,804.6479381990924,0.1344525418227952,0.8655474581772047,7872,52,7924,0.9934376577486118,0.0065623422513881,48251972
92691,5582,45571,5602,11930,750800.0,118035.75,66092392,71582,51173,0.0,9.131203141735094,4.2877619446772846,6.360784762243642,64287.74152631056,923.3102176524824,0.1094717917651886,0.8905282082348114,11920,10,11930,0.9991617770326908,0.0008382229673093,8668849
92692,6927,48144,6989,12858,795500.0,121326.0,79693367,75783,55133,0.0,7.8796680497925315,4.283014465702286,6.556714966289172,67955.23101467558,1051.599527598538,0.1267661835924038,0.8732338164075962,12832,26,12858,0.9979779125836056,0.0020220874163944,23608788
92694,6098,25708,5108,7495,844700.0,167172.0,50723559,48712,30816,0.0,6.226703210649961,4.243629086057371,5.0528796688440645,70234.93447518411,1041.2949375923797,0.1657580477673935,0.8342419522326064,7453,42,7495,0.9943962641761174,0.0056037358238825,49400216
92701,1599,14278,1668,3895,521700.0,52651.5,12349031,26203,15946,0.0,9.518585131894485,4.0762516046213095,9.908549613971111,47988.07883540984,471.28309735526466,0.1046030352439483,0.8953969647560517,3818,77,3895,0.9802310654685494,0.0197689345314505,27662202
92703,3710,26619,3379,7493,486000.0,64066.0,17924970,37613,29998,0.0,8.975732465226399,4.047644468170292,7.585927012768083,43911.685147479824,476.5631563555154,0.1126408427228481,0.8873591572771518,7396,97,7493,0.98705458427866,0.0129454157213399,32886383
92704,4791,38781,4538,10615,534800.0,72988.75,33072599,63766,43319,0.0,9.601586602027323,4.104757418747056,7.327156582350019,47758.2698618133,518.6556942571276,0.1047577275560377,0.8952422724439623,10533,82,10615,0.9922750824305228,0.0077249175694771,31075162
92705,4262,37034,4217,9733,914900.0,108953.75,60536451,54949,41251,0.0,9.792743656627934,4.242885030309258,8.39714098872228,78879.67405522279,1101.6843072667382,0.1022278247800053,0.8977721752199946,9699,34,9733,0.9965067296825234,0.0034932703174766,61540300
92706,2372,20786,2356,5513,673300.0,73836.0,19605420,28306,23142,0.0,9.82937181663837,4.200616724106657,9.118858009642992,60064.57840589597,692.624178619374,0.1018062397372742,0.8981937602627258,5507,6,5513,0.9989116633411936,0.0010883366588064,4321155
92707,2947,28316,2934,7631,539700.0,81652.25,23398158,47563,31250,0.0,10.655419222903886,4.09684182938016,6.6097382497114285,47717.88505345776,491.94033177049386,0.093888,0.906112,7554,77,7631,0.9899095793473988,0.0100904206526012,26955115
92708,5657,50746,5413,13302,816900.0,89763.25,59975327,78153,56159,0.0,10.419915019397749,4.240189445196211,9.10060631717323,71626.91340911257,767.4091461620155,0.0963870439288448,0.9036129560711552,13293,9,13302,0.9993234100135318,0.0006765899864682,7746716
92780,3163,27649,3097,7317,669400.0,76300.5,31875635,56961,30746,0.0,9.948982886664512,4.211015443487768,8.773205942293956,59542.26230127284,559.604553993083,0.1007285500552917,0.8992714499447082,7315,2,7317,0.999726663933306,0.000273336066694,1059623
92782,2398,17006,2319,4495,879300.0,120005.0,31836298,46288,19325,0.0,8.367399741267787,4.316796440489433,7.327194700220824,75184.1210157624,687.7872882820601,0.12,0.88,4483,12,4495,0.9973303670745272,0.0026696329254727,13669564
92801,3105,24559,2927,6822,543200.0,65148.0,22705445,48757,27486,0.0,9.451315339938503,4.0551158018176485,8.337938232946522,49005.735321910746,465.68585023688905,0.1064905770210288,0.8935094229789711,6802,20,6822,0.9970683084139548,0.0029316915860451,10841513
92802,2140,16265,2099,4436,577500.0,64041.25,15816392,31640,18364,0.0,8.76846117198666,4.149008115419297,9.017625358655554,52180.83032541112,499.8859671302149,0.1142997168372903,0.8857002831627097,4421,15,4436,0.9966185752930568,0.0033814247069431,8294654
92804,5507,42736,5313,11496,594400.0,66245.5,38210176,72454,48049,0.0,9.08018068887634,4.196503131524008,8.972684937090067,53544.13330956427,527.3715184806912,0.1105746217403067,0.8894253782596933,11474,22,11496,0.9980862908837856,0.0019137091162143,9371495
92805,3729,31960,3591,8739,583800.0,68799.75,29431697,62101,35551,0.0,9.938457254246728,4.0838768737841855,8.485495950203308,52410.659666879,473.9327386032431,0.1010098168827881,0.8989901831172119,8715,24,8739,0.9972536903535874,0.0027463096464126,15997761
92806,2337,20108,2267,5368,623300.0,74536.25,21569551,43907,22375,0.0,9.9007498897221,4.181259314456036,8.362374012644853,55557.33396462026,491.2554034664177,0.1013184357541899,0.89868156424581,5357,11,5368,0.9979508196721312,0.0020491803278688,2555158
92807,4412,35104,4293,9245,731100.0,116875.5,55607136,52684,39397,0.0,9.204751921733054,4.274310438074635,6.255374308559108,62653.910944126816,1055.4843216156708,0.1089676878950173,0.8910323121049826,9178,67,9245,0.9927528393726338,0.0072471606273661,88718276
92808,2483,17576,2498,4682,807100.0,130167.75,32449661,31459,20074,0.0,8.030024019215372,4.284280222127296,6.200460559547199,68534.33247958317,1031.4905432467656,0.1244395735777622,0.8755604264222377,4648,34,4682,0.992738146091414,0.007261853908586,50274519
92821,3982,33808,3960,8902,700900.0,95882.75,41635364,55797,37768,0.0,9.542929292929292,4.245113457649967,7.309969728652964,61102.54106924382,746.1935946377046,0.1048506672315187,0.8951493327684813,8838,64,8902,0.9928106043585712,0.0071893956414288,71872611
92823,839,5162,759,1435,913900.0,146803.5,7474320,8199,5921,0.0,7.906455862977603,4.181881533101046,6.22532841519446,76818.65214794301,911.6136114160264,0.1281878061138321,0.8718121938861679,1380,55,1435,0.9616724738675958,0.0383275261324041,43867650
92831,2238,20330,2181,5337,676300.0,74103.25,25073199,43984,22511,0.0,10.347546996790465,4.228592842420836,9.126455317411857,60312.766669053635,570.0527237177155,0.0968859668606459,0.903114033139354,5326,11,5337,0.9979389169945664,0.0020610830054337,8541509
92832,1546,14565,1501,3853,615300.0,68635.75,13332720,28947,16066,0.0,10.733510992671553,4.181417077601869,8.964715909711776,55250.41062661005,460.59073479117006,0.0934271131582223,0.9065728868417776,3846,7,3853,0.998183233843758,0.0018167661562418,3925307
92833,4875,38534,4817,10190,686700.0,85986.0,39297089,60266,43351,0.0,9.011625493045464,4.259960745829244,7.9861837973623615,60438.623494152554,652.0606809809843,0.1111162372263615,0.8888837627736385,10168,22,10190,0.9978410206084396,0.0021589793915603,16384800
92835,2777,23509,2704,6168,831100.0,116427.5,34190517,35700,26213,0.0,9.721153846153848,4.261673151750973,7.138347898907045,71247.17421089583,957.71756302521,0.1031549231297447,0.8968450768702552,6157,11,6168,0.9982166018158236,0.0017833981841763,10726029
92840,4527,32753,4303,8952,590900.0,74320.75,27267529,49831,37056,0.0,8.663722983964675,4.164432529043789,7.950673264196069,52682.98292380679,547.2001163934098,0.1161215457685665,0.8838784542314335,8946,6,8952,0.9993297587131368,0.0006702412868632,3147637
92841,3075,21919,2852,6015,609900.0,64257.5,18246116,31322,24771,0.0,8.763674614305751,4.15527847049044,9.491499046803876,55091.59757088721,582.5335546899943,0.1151346332404828,0.8848653667595172,6013,2,6015,0.999667497921862,0.0003325020781379,2868784
92843,3010,22188,2851,6073,570200.0,67275.0,16706027,33633,25039,0.0,8.838302350052613,4.149184916845052,8.47565960609439,51292.91992653456,496.7153391014777,0.113862374695475,0.8861376253045249,6064,9,6073,0.998518030627367,0.0014819693726329,3488067
92844,1409,10152,1341,2764,545400.0,60930.75,9518356,20291,11493,0.0,8.621178225205071,4.182706222865413,8.951145357639616,49503.09362635427,469.092504065842,0.1166797180892717,0.8833202819107283,2763,1,2764,0.9996382054992764,0.0003617945007235,1185378
92845,1587,18566,1597,4809,668900.0,106713.5,16672068,24054,20163,0.0,12.619286161552912,4.190684133915575,6.268185374858851,57773.84754033723,693.1100024943876,0.0792044834598026,0.9207955165401974,4808,1,4809,0.9997920565606156,0.0002079434393844,483400
92860,3487,23995,3434,6438,595300.0,105099.25,32023663,28931,27429,1.8333333333333333,8.002912055911473,4.268716992854924,5.664169820431639,51484.691094985006,1106.8978949915315,0.1251959604797841,0.8748040395202158,6409,29,6438,0.9954954954954957,0.0045045045045045,21716973
92865,1883,16107,1823,4267,652400.0,107916.0,17292300,25501,17930,0.0,9.868348875479978,4.21607686899461,6.045442751769895,56294.23559047014,678.1028194972746,0.1016731734523145,0.8983268265476855,4257,10,4267,0.9976564330911648,0.0023435669088352,3606800
92866,1192,11423,1145,3049,722200.0,75276.0,10908558,20791,12568,0.0,11.017467248908297,4.137422105608397,9.594027312822147,64316.088834732414,524.6769275167139,0.0911043921069382,0.9088956078930618,3048,1,3049,0.9996720236142996,0.0003279763857002,609015
92867,4310,37596,4245,9955,780900.0,99352.75,48397112,50153,41841,0.0,9.871849234393403,4.2095429432446005,7.859873028174862,67866.39028668514,964.9893725200884,0.101455510145551,0.898544489854449,9943,12,9955,0.9987945755901556,0.0012054244098442,16044162
92868,1123,10195,1087,2779,531900.0,69730.5,11464677,30033,11282,0.0,10.41214351425943,4.0726880172724,7.627938993697162,47693.79949881362,381.7359904105484,0.0963481652189328,0.9036518347810673,2776,3,2779,0.998920474991004,0.001079525008996,3166696
92869,3664,31286,3645,8240,770700.0,115736.75,48702489,47845,34931,0.0,9.588477366255145,4.241504854368932,6.6590776049958205,66103.0227110247,1017.9222280280072,0.1043485729008617,0.8956514270991383,8215,25,8240,0.9969660194174758,0.0030339805825242,28283868
92870,4653,40919,4572,10774,696700.0,97046.5,49123407,65709,45491,0.0,9.967629046369204,4.229812511602005,7.179032731731696,60672.586013761145,747.5902387800758,0.1005033962761865,0.8994966037238135,10759,15,10774,0.998607759420828,0.001392240579172,11373517
92879,4987,32990,4995,9122,452900.0,71307.25,37669454,52666,37985,1.8333333333333333,7.603003003003003,4.1632317474238105,6.351387832233048,40528.858980522105,715.2518512892568,0.1314992760300118,0.8685007239699881,9041,81,9122,0.9911203683402764,0.0088796316597237,40205949
92881,5037,28571,4867,7912,615000.0,112726.0,43417137,37581,33438,1.8333333333333333,6.905280460242449,4.247724974721941,5.4557067579795255,52868.13785142613,1155.2948830526063,0.1455529636940008,0.8544470363059992,7843,69,7912,0.9912790697674418,0.0087209302325581,73956248
92882,8231,51985,8146,14313,521000.0,83236.75,67499664,74380,60131,1.8333333333333333,7.392094279400933,4.20708446866485,6.259254475937611,45986.36871734079,907.4974993277764,0.1354708885599773,0.8645291114400226,14001,312,14313,0.9782016348773842,0.0217983651226158,293407861
92883,8509,34334,7410,11253,538500.0,109274.0,49997985,48337,41744,1.8333333333333333,5.781781376518219,3.8072513996267663,4.927979208228856,46415.95649940496,1034.3626000786148,0.177510540436949,0.822489459563051,10984,269,11253,0.9760952634852929,0.0239047365147071,234903310
92886,6474,51536,6146,13669,864700.0,127809.25,80976292,71577,57682,0.0,9.43865929059551,4.243909576413783,6.765551006675964,73539.57857415405,1131.317210835883,0.1065497035470337,0.8934502964529663,13587,82,13669,0.9940010242153778,0.0059989757846221,107642767
92887,2930,20076,3035,5427,903900.0,141490.0,39478028,29783,23111,0.0,7.580230642504119,4.239174497880965,6.388437345395435,76214.26600950943,1325.5222106570864,0.1313227467439747,0.8686772532560253,5210,217,5427,0.9600147411092684,0.0399852588907315,308187640
93003,5007,45511,4949,11838,617700.0,81284.25,48120313,76677,50460,0.0,10.20771873105678,4.267443824970434,7.599258158868415,54636.12049731691,627.5716707748086,0.0980776852952833,0.9019223147047166,11794,44,11838,0.9962831559385033,0.0037168440614968,67761130
93004,3400,30155,3182,7923,608100.0,91622.5,29704543,43466,33337,0.0,10.545254556882464,4.235138205225294,6.637016016808098,53223.36974394093,683.3972070123775,0.0954495005549389,0.904550499445061,7911,12,7923,0.998485422188565,0.001514577811435,14252699
93010,5172,43680,4961,11415,662300.0,95577.5,54177195,67908,48641,0.0,9.847208224148355,4.279632063074901,6.92945515419424,57753.55308342188,797.8028361901396,0.1019921465430398,0.8980078534569602,11378,37,11415,0.9967586508979414,0.0032413491020586,44847715
93012,4326,34202,4159,9110,657700.0,105784.75,52535408,59979,38361,0.0,9.263765328203895,4.229198682766191,6.217342291776461,56849.40879932073,875.8966971773455,0.1084174030916816,0.8915825969083183,8998,112,9110,0.9877058177826564,0.0122941822173435,196130439
93015,2252,13870,1789,4188,456600.0,72761.25,12891495,17857,15659,0.0,9.011738401341532,3.849570200573066,6.275318249755193,40786.28813050961,721.9294954359635,0.1142473976626859,0.885752602337314,4070,118,4188,0.971824259789876,0.0281757402101241,112258946
93021,4759,35081,4634,9392,690900.0,114196.5,48842195,49898,39715,0.0,8.597324126025033,4.2419080068143105,6.050097857640121,59326.741039889144,978.8407350996032,0.1166813546518947,0.8833186453481052,9216,176,9392,0.9812606473594548,0.0187393526405451,200655422
93022,953,7086,942,1962,610500.0,88768.25,7800711,8917,8028,0.0,8.533970276008493,4.097349643221203,6.877459001388447,53581.84628160137,874.8133901536391,0.1173393124065769,0.882660687593423,1911,51,1962,0.9740061162079512,0.0259938837920489,52656220
93023,3373,24358,3373,6821,692700.0,77675.0,34044110,33319,27731,0.0,8.221464571597984,4.065532913062601,8.917927261023495,61517.07263885235,1021.7626579429154,0.1216328296851898,0.8783671703148102,6296,525,6821,0.9230318135170796,0.0769681864829203,765024470
93030,3903,36190,4009,9390,530000.0,75646.25,34384211,50723,40199,0.0,10.000748316288352,4.26975505857295,7.006295751606986,47178.951727874475,677.88204562033,0.0997288489763427,0.9002711510236573,9374,16,9390,0.9982960596379128,0.0017039403620873,9999567
93033,4398,41488,4233,10996,442700.0,67472.25,33869966,53724,45721,0.0,10.840066146940703,4.172971989814478,6.561215907280401,39813.0426239299,630.4438612165885,0.0925832768312154,0.9074167231687846,10973,23,10996,0.997908330301928,0.002091669698072,15689632
93035,3705,29028,3633,7787,632800.0,89387.5,37332914,49213,32661,0.0,9.00990916597853,4.203544368819828,7.079289609844777,55505.187802307635,758.5986223152419,0.1112335813355378,0.8887664186644622,7772,15,7787,0.9980737125979195,0.0019262874020803,11937756
93036,3271,25387,2921,6837,527700.0,77824.75,26810072,47261,28308,0.0,9.811023622047244,4.19160450489981,6.780619276001529,46855.79259223398,567.2768667611773,0.1031863784089303,0.8968136215910697,6818,19,6837,0.9972210033640484,0.0027789966359514,9196226
93040,208,1286,150,385,393500.0,58537.5,1288906,1541,1436,0.0,9.96,3.8805194805194807,6.7221866325005335,35846.30065287428,836.4088254380273,0.1044568245125348,0.8955431754874652,366,19,385,0.9506493506493506,0.0493506493506493,8400250
93041,1430,12657,1399,3132,446800.0,64508.0,13002607,28847,14056,0.0,10.069335239456755,4.497765006385696,6.926272710361506,40344.77435591008,450.74382084792177,0.0995304496300512,0.9004695503699488,3127,5,3132,0.9984035759897828,0.0015964240102171,3240115
93060,3319,22504,2659,6751,446700.0,63461.75,20555598,30338,25163,0.0,9.711545693869876,3.825062953636498,7.038885627956998,40395.389598874805,677.5528380249192,0.1056710249175376,0.8943289750824623,6541,210,6751,0.9688934972596652,0.0311065027403347,227315152
93063,6813,53137,6657,14337,626900.0,95976.0,67696870,77796,59794,0.0,9.00555805918582,4.181488456441375,6.531841293656748,54646.79298099572,870.1844567844105,0.1113322406930461,0.8886677593069539,13960,377,14337,0.9737044011996931,0.0262955988003068,285755530
93065,9574,68494,9227,18441,642900.0,100799.75,91280238,102409,77721,0.0,8.460821502113363,4.233392983026951,6.377992008908752,55802.97490713231,891.3302346473455,0.1187195223942049,0.8812804776057951,18231,210,18441,0.9886123312184806,0.0113876687815194,265247291
93066,318,2641,307,764,1068500.0,112416.25,5415454,3589,2948,0.0,9.63843648208469,3.87303664921466,9.504853613245416,91874.7487360493,1508.9033156868209,0.1041383989145183,0.8958616010854816,705,59,764,0.9227748691099475,0.0772251308900523,89740294
93101,1757,17092,1779,4561,905500.0,61900.5,20579360,34665,18871,0.0,10.595278246205734,4.132646349484762,14.628314795518614,82069.8568137349,593.6639261502957,0.094271633723703,0.9057283662762968,4534,27,4561,0.9940802455601842,0.0059197544398158,14597672
93103,1825,14752,1841,4046,1117000.0,91916.25,25606500,25615,16593,0.0,9.00434546442151,4.097132970835393,12.152366964492131,97736.97245562536,999.6681631856334,0.1109504007714096,0.8890495992285904,3873,173,4046,0.9572417202174988,0.0427582797825012,354870829
93105,3069,23159,2998,6458,1180200.0,99674.0,43082045,40993,26157,0.0,8.748498999332888,4.06131929389904,11.840600357164355,102539.95215202829,1050.9610177347352,0.1146155904729135,0.8853844095270864,5739,719,6458,0.8886652214307835,0.1113347785692164,1069584060
93109,1244,12088,1291,3159,1413400.0,98515.0,17692614,18271,13379,0.0,10.326878388845856,4.220322886989553,14.347053748160178,122926.11002506864,968.3440424716764,0.0964945063158681,0.9035054936841318,3150,9,3159,0.9971509971509972,0.0028490028490028,12395977
93110,1909,15122,1935,3996,875700.0,90266.25,28442022,24037,17057,0.0,8.8015503875969,4.262012012012012,9.701300319887,76744.97597291476,1183.2600574114906,0.1134431611655039,0.8865568388344961,3964,32,3996,0.991991991991992,0.008008008008008,65137961
93111,1963,18208,1778,4820,961100.0,116598.5,25049840,26557,19986,0.0,11.344769403824522,4.184854771784233,8.242816159727612,82381.23556562132,943.2481078435064,0.088962273591514,0.911037726408486,4761,59,4820,0.9877593360995852,0.0122406639004149,107207177
93117,2418,25361,2257,6702,838300.0,69385.0,34030212,51592,27618,1.8333333333333333,12.307930881701374,4.144882124738884,12.081862073935287,75201.2169574101,659.602496511087,0.081722065319719,0.918277934680281,6539,163,6702,0.975678901820352,0.0243210981796478,223307258
93201,87,372,96,101,91000.0,35571.0,301029,477,468,0.0,4.78125,4.544554455445544,2.558263754181777,8683.797750147083,631.0880503144654,0.2051282051282051,0.7948717948717948,97,4,101,0.9603960396039604,0.0396039603960396,$                                   -
93203,2071,11368,1823,3410,192800.0,40180.75,7878734,13458,13191,0.0,7.371914426769062,3.941055718475073,4.798317602334452,18186.717646167235,585.4312676474959,0.1382002880752028,0.8617997119247972,3387,23,3410,0.9932551319648094,0.0067448680351906,3991882
93204,693,5028,631,1401,180200.0,46171.0,3499469,5630,5659,0.0,9.066561014263074,4.083511777301927,3.9028827619068247,16778.231080442125,621.5753108348135,0.1115037992578194,0.8884962007421806,1399,2,1401,0.9985724482512492,0.0014275517487508,399917
93205,597,2476,910,770,109500.0,22824.0,2738577,3592,3386,0.0,3.376923076923077,3.9909090909090903,4.797581493165089,10911.1911920343,762.4100779510022,0.2687536916715889,0.7312463083284111,538,232,770,0.6987012987012987,0.3012987012987013,57361022
93206,144,1051,130,298,152200.0,41447.75,801242,1309,1181,0.0,9.192307692307692,4.010067114093959,3.6720931775548737,14315.020337137636,612.1023682200153,0.1100762066045724,0.8899237933954276,293,5,298,0.9832214765100672,0.0167785234899328,1165430
93212,1481,9726,1441,2722,176400.0,41472.75,7229541,11513,11167,0.0,7.777238029146426,4.117193240264512,4.253395301734272,16590.186496229366,627.9458872578824,0.1290409241515178,0.8709590758484821,2703,19,2722,0.9930198383541512,0.0069801616458486,5200731
93215,3689,28811,3399,8242,215100.0,44933.75,22195590,34719,32210,0.0,9.561635775228009,3.943217665615142,4.787047597852394,20078.513500007208,639.2923183271407,0.1055262340887923,0.8944737659112078,8213,29,8242,0.996481436544528,0.0035185634554719,7958248
93218,87,480,107,122,134500.0,29497.0,407522,611,587,0.0,5.299065420560748,4.647540983606557,4.5597857409228055,13068.346973802716,666.9754500818331,0.1822827938671209,0.817717206132879,122,0,122,1.0,0.0,$                                   -
93219,634,4747,635,1307,162500.0,36167.75,3345822,5659,5382,0.0,8.474015748031496,4.117061973986228,4.492952976062929,15482.201821817094,591.2390881781233,0.117985878855444,0.8820141211445559,1304,3,1307,0.9977046671767408,0.0022953328232593,1357800
93221,2173,14085,2050,3840,278600.0,56978.25,12814807,16831,16135,0.0,7.930731707317073,4.233854166666666,4.889585060966246,25441.93514590919,761.3812013546432,0.1270529903935544,0.8729470096064457,3833,7,3840,0.9981770833333332,0.0018229166666666,2176143
93222,761,4100,761,1599,282500.0,51860.0,7802432,6958,4861,0.0,6.387647831800263,3.0400250156347717,5.4473582722715,26021.749619765193,1121.3613107214717,0.1565521497634231,0.8434478502365769,935,664,1599,0.5847404627892433,0.4152595372107567,370039823
93223,1010,7563,1052,2041,189100.0,42430.25,5289671,8890,8615,0.0,8.149239543726235,4.200391964723175,4.456726038616317,17746.509002032366,595.0136107986501,0.122112594312246,0.8778874056877539,2033,8,2041,0.9960803527682508,0.0039196472317491,1556431
93230,8932,59717,8189,16745,252300.0,64066.75,48882598,73900,67906,0.0,8.383074856514837,4.099671543744401,3.938080205410763,22796.10379467921,661.4695263870095,0.1205931729155008,0.8794068270844991,16732,13,16745,0.9992236488504032,0.0007763511495968,6810703
93234,291,2043,255,542,190000.0,29170.75,1598055,2321,2298,0.0,9.152941176470588,4.306273062730627,6.513373841947842,18480.833156687066,688.5200344679017,0.1109660574412532,0.8890339425587467,541,1,542,0.9981549815498156,0.0018450184501845,563660
93235,385,3093,393,834,175600.0,38517.5,2085149,3614,3486,0.0,8.849872773536896,4.170263788968825,4.558966703446486,16630.57068469644,576.964305478694,0.112736660929432,0.887263339070568,833,1,834,0.998800959232614,0.001199040767386,256395
93240,1266,7776,1293,2190,177900.0,36506.0,7763454,9658,9069,0.0,6.993039443155452,4.1287671232876715,4.873171533446556,16934.419109495782,803.8366121350176,0.14257360238174,0.85742639761826,2053,137,2190,0.9374429223744292,0.0625570776255707,57472452
93241,1180,7692,1167,2162,147600.0,37971.5,4608128,9017,8859,0.0,7.602399314481577,4.103607770582793,3.8871258707188288,13997.697757827946,511.048907618942,0.131730443616661,0.868269556383339,2145,17,2162,0.99213691026827,0.0078630897317298,3513542
93245,3716,25959,3425,7173,261400.0,63161.0,22714200,38320,29384,0.0,8.664233576642335,4.137041684093127,4.138629850699007,23648.741530516083,592.750521920668,0.1165600326708412,0.8834399673291587,7171,2,7173,0.999721176634602,0.000278823365398,849801
93247,1696,11659,1583,3177,208800.0,38067.25,8692781,13634,13242,0.0,8.436512950094757,4.2036512433113,5.485029782818565,19796.89295862511,637.5811207275927,0.1195438755475003,0.8804561244524997,3172,5,3177,0.998426188227888,0.001573811772112,2240343
93249,79,757,87,221,149100.0,35719.75,499647,940,844,0.0,9.60919540229885,3.7828054298642537,4.174161353312943,14222.404979766092,531.5393617021276,0.1030805687203791,0.8969194312796208,220,1,221,0.995475113122172,0.004524886877828,324486
93250,1121,9071,1087,2557,203700.0,37132.75,6100085,10643,10158,0.0,9.376264949402024,3.9859210011732498,5.485723518996035,19358.968926195143,573.1546556422062,0.1070092537901161,0.8929907462098838,2551,6,2557,0.9976535001955416,0.0023464998044583,1649738
93254,120,682,122,192,182200.0,47163.0,564977,862,804,0.0,6.573770491803279,4.177083333333333,3.863197845768929,16930.93771821963,655.4257540603248,0.1517412935323383,0.8482587064676617,177,15,192,0.921875,0.078125,6499103
93256,423,2646,403,754,162700.0,34890.75,1917775,3306,3049,0.0,7.615384615384615,4.070291777188329,4.663127046566784,15554.5274652241,580.0892316999395,0.1321744834371925,0.8678255165628075,746,8,754,0.9893899204244032,0.0106100795755968,1926117
93257,8209,57829,7523,16103,211800.0,44511.25,44010909,70579,65352,0.0,8.778147015818158,4.100974973607403,4.758347608750597,19787.924932211725,623.5694611711699,0.1151150691639123,0.8848849308360877,16027,76,16103,0.9952803825374154,0.0047196174625846,21013143
93263,2796,15389,2067,4808,206700.0,47735.25,11178318,18584,17456,0.0,8.797774552491534,3.7822379367720464,4.330133391990196,19186.098419986803,601.5022600086096,0.1184120073327222,0.8815879926672777,4798,10,4808,0.9979201331114808,0.0020798668885191,3704565
93267,611,3669,584,1030,143000.0,33337.0,2921302,4564,4253,0.0,7.328767123287672,4.155339805825243,4.289528151903291,13730.95731393562,640.0749342681858,0.1373148365859393,0.8626851634140607,1025,5,1030,0.9951456310679612,0.0048543689320388,3548865
93268,2624,14878,2550,4124,164200.0,44572.0,10859248,18987,17428,0.0,6.863529411764706,4.243937924345296,3.68392712913937,15338.825780239586,571.9306894190762,0.1463162726646775,0.8536837273353225,4079,45,4124,0.9890882638215324,0.0109117361784675,8489459
93270,449,3226,433,882,221700.0,39310.75,2695391,3914,3659,0.0,8.48729792147806,4.166666666666667,5.639678713837818,20956.110395387015,688.6538068472152,0.1183383438097841,0.8816616561902159,872,10,882,0.9886621315192744,0.0113378684807256,3055815
93271,477,3686,566,1147,333600.0,72190.75,5258574,4713,4252,0.0,7.355123674911661,3.629468177855274,4.621090652195745,29820.14803577514,1115.759388924252,0.1331138287864534,0.8668861712135466,913,234,1147,0.7959895379250218,0.2040104620749782,154873029
93272,244,1760,236,492,185200.0,40004.0,1209748,2116,1996,0.0,8.491525423728813,4.073170731707317,4.62953704629537,17477.081832477776,571.7145557655955,0.1182364729458917,0.8817635270541082,490,2,492,0.9959349593495936,0.0040650406504065,391195
93274,9483,61699,8195,17554,246600.0,55576.5,46313877,75637,69894,0.0,8.686028065893838,4.055030192548707,4.437127203044453,22571.016885267574,612.3177413170803,0.1172489770223481,0.8827510229776518,17521,33,17554,0.998120086589951,0.0018799134100489,8336894
93277,7498,51674,7392,14085,256600.0,62554.0,43413019,65832,59066,0.0,8.00487012987013,4.201064962726305,4.102055823768264,23234.786737469563,659.4516192733017,0.1251481393695188,0.8748518606304811,14081,4,14085,0.9997160099396522,0.0002839900603478,4522355
93280,1978,15947,1793,4474,188300.0,39330.0,10387766,18151,17740,0.0,9.997211377579475,4.006481895395619,4.787693872362064,17798.164132642232,572.2971737094375,0.1010710259301014,0.8989289740698986,4466,8,4474,0.9982118909253463,0.0017881090746535,1634036
93283,333,2662,345,743,119800.0,29950.25,2650446,3204,3007,0.0,8.681159420289855,4.0309555854643335,3.999966611297068,11622.838370110983,827.2303370786517,0.1147322913202527,0.8852677086797472,701,42,743,0.9434724091520862,0.0565275908479138,14357234
93285,970,4558,1444,1603,101600.0,30037.75,7503651,7015,6002,0.0,3.828254847645429,3.4485339987523393,3.38241046682924,9854.30927208746,1069.6580185317175,0.2405864711762745,0.7594135288237254,973,630,1603,0.6069868995633187,0.3930131004366812,185597379
93286,1092,6724,917,1957,232800.0,42869.5,5392286,7986,7641,0.0,8.523446019629226,3.99386816555953,5.430434224798517,21826.53625456859,675.2173804157276,0.1200104698337913,0.8799895301662086,1947,10,1957,0.9948901379662748,0.005109862033725,11644514
93291,9074,53021,7979,15215,294800.0,63234.75,45133078,65532,61000,0.0,7.782303546810377,4.0811698981268485,4.661993603200772,26667.60920973548,688.7181529634377,0.1308032786885246,0.8691967213114754,15173,42,15215,0.9972395662175484,0.0027604337824515,8891252
93292,6677,39177,5610,11300,252500.0,63713.0,32484171,48931,44787,0.0,8.17361853832442,4.057876106194691,3.963084456861237,22825.59350415597,663.8771126688603,0.1252595619264518,0.8747404380735482,11283,17,11300,0.9984955752212388,0.001504424778761,4386130
93301,1590,8285,1596,2357,190600.0,32954.25,7739299,13566,9881,0.0,6.18734335839599,4.189647857445906,5.783775992474415,18321.857233283084,570.4923337756155,0.1615221131464426,0.8384778868535573,2323,34,2357,0.9855748833262622,0.0144251166737378,5663966
93304,6473,38568,6534,10783,179300.0,41421.5,28148448,48829,45102,0.0,6.89332721150903,4.177037930075119,4.328669893654261,16864.888919776964,576.4698846996662,0.144871624318212,0.8551283756817879,10610,173,10783,0.9839562273949736,0.0160437726050264,31029479
93305,4641,25057,4707,7285,169300.0,32219.0,18660020,31810,29764,0.0,6.3093265349479495,4.076595744680851,5.2546633973742205,16309.722309290184,586.6086136435083,0.1581440666577073,0.8418559333422927,7113,172,7285,0.9763898421413864,0.0236101578586135,28492751
93306,10550,62953,9697,17827,227700.0,55923.5,55763435,78945,72650,0.0,7.579973187583789,4.123127839793572,4.071633570860193,20829.255062991113,706.3580340743556,0.1334755677907777,0.8665244322092223,17752,75,17827,0.9957928984125204,0.0042071015874796,19631594
93307,9808,55194,8900,16422,187100.0,41496.5,39520412,68573,64094,0.0,7.303595505617977,3.958226768968457,4.508813996361139,17595.559934947847,576.3261341927581,0.1388585515024807,0.8611414484975193,16145,277,16422,0.983132383388138,0.0168676166118621,48494338
93308,8058,47332,7954,13074,242800.0,45734.25,40491464,63350,55286,0.0,6.963791802866482,4.23665289888328,5.308931490075818,22626.87434026326,639.1707024467246,0.1438700575190825,0.8561299424809174,12988,86,13074,0.9934220590484932,0.0065779409515068,18843870
93309,7259,45364,7126,12282,226200.0,52105.25,44906343,70644,52490,0.0,7.3846477687342125,4.284562774792379,4.341213217478085,20826.77127680172,635.6710124002038,0.1357591922270908,0.8642408077729091,12255,27,12282,0.9978016609672692,0.0021983390327308,8719896
93312,9720,66412,9585,17758,328400.0,98818.5,65899592,81133,75997,0.0,7.94282733437663,4.287194503885573,3.3232643685139927,28553.939188849203,812.2415293407122,0.1261233996078792,0.8738766003921208,17744,14,17758,0.9992116229305102,0.0007883770694898,7563323
93313,9632,51297,8161,15262,283400.0,80867.25,43554523,62629,59458,0.0,7.465874280112732,3.992202856768445,3.504508932849825,25078.393872760895,695.4369860607706,0.1372565508426116,0.8627434491573884,15234,28,15262,0.9981653780631634,0.0018346219368365,7349400
93314,6087,33577,4822,9872,412200.0,112445.75,37159164,40504,38399,0.0,8.22563251762754,4.017828200972447,3.665767714653511,35442.13106907005,917.4196128777404,0.1255761868798666,0.8744238131201333,9858,14,9872,0.998581847649919,0.001418152350081,6740369
93401,3787,29880,3241,8505,775100.0,75138.75,32270376,51333,33121,0.0,10.387843258253625,3.958495002939447,10.315582838415596,69038.36023248026,628.6477704400678,0.0978533256846109,0.902146674315389,8431,74,8505,0.9912992357436802,0.0087007642563198,96003756
93402,2174,20462,2083,5427,616100.0,79349.5,18164133,26093,22545,0.0,10.86701872299568,4.170996867514281,7.764384148608372,54610.963730170704,696.130494768712,0.0923929917941894,0.9076070082058106,5397,30,5427,0.9944720840243229,0.0055279159756771,34692374
93405,2229,17497,1992,4897,753500.0,47251.25,18867040,34044,19489,0.0,9.902610441767068,4.028180518684909,15.946668077564086,70006.83743059574,554.1957466807661,0.1022115039252911,0.8977884960747088,4846,51,4897,0.9895854604860118,0.0104145395139881,43186791
93420,4187,36668,3897,9995,710000.0,88571.75,40865226,48635,40565,0.0,10.48370541442135,4.087543771885943,8.016099941572792,62326.80042194979,840.2431582193893,0.0960680389498336,0.9039319610501664,9868,127,9995,0.9872936468234116,0.0127063531765882,124780169
93422,4547,36720,4395,9843,573000.0,82842.25,38024380,50079,41115,0.0,9.38953356086462,4.192522604896881,6.916760469446448,50597.39596641179,759.2879250783761,0.1068952936884348,0.8931047063115651,9682,161,9843,0.9836431982119272,0.0163568017880727,157278015
93427,680,5802,612,1581,621600.0,97334.75,6246718,8229,6414,1.8333333333333333,10.591503267973856,4.099936748893105,6.386208419911696,54118.47446895837,759.1102199538218,0.0954162768942937,0.9045837231057062,1554,27,1581,0.98292220113852,0.01707779886148,50400533
93428,1611,12865,1556,3600,705200.0,75876.25,15888429,15902,14421,0.0,9.303341902313624,4.021111111111111,9.294080822391724,62757.75106114076,999.146585335178,0.1078982040080438,0.8921017959919562,3480,120,3600,0.9666666666666668,0.0333333333333333,117403551
93430,788,6393,742,1888,896700.0,68433.25,7283034,8500,7135,0.0,9.677897574123987,3.8034957627118646,13.103279473063168,80539.88509204656,856.8275294117647,0.1039943938332165,0.8960056061667835,1865,23,1888,0.9878177966101694,0.0121822033898305,15268019
93433,1691,14466,1538,3901,577300.0,69148.75,11282511,21532,16004,0.0,10.50520156046814,4.1417585234555245,8.348668631030929,51803.590224557855,523.9880642764258,0.0961009747563109,0.903899025243689,3898,3,3901,0.999230966418867,0.000769033581133,1384342
93434,804,5591,550,1733,337100.0,52546.25,3763128,6884,6141,1.8333333333333333,11.627272727272729,3.690132717830352,6.415300806432429,31013.531559159645,546.6484601975595,0.0895619605927373,0.9104380394072626,1720,13,1733,0.9924985574148876,0.0075014425851125,2277322
93436,5650,45128,5408,12132,373600.0,63426.25,39259545,62725,50536,1.8333333333333333,9.389423076923077,4.185459940652819,5.8903056699710294,33786.61571347964,625.899481865285,0.107012822542346,0.892987177457654,12035,97,12132,0.9920046158918564,0.0079953841081437,81507791
93441,174,1337,176,325,927500.0,102212.0,2346390,1734,1513,0.0,8.585227272727273,4.649230769230769,9.074276992916683,80408.81930156742,1353.166089965398,0.1163251817580965,0.8836748182419035,276,49,325,0.8492307692307692,0.1507692307692307,53776552
93442,2068,17807,1999,4899,711900.0,73078.5,15863566,24857,19806,0.0,9.942471235617807,4.056950398040416,9.74157926065806,63566.53258801116,638.1931045580722,0.1009290114106836,0.8990709885893163,4883,16,4899,0.9967340273525208,0.003265972647479,12995719
93444,3467,25013,3058,6948,643200.0,90509.25,24191812,31854,28071,0.0,9.313276651406149,4.09902130109384,7.10645596996992,56355.762333416635,759.4591574056633,0.1089380499447828,0.8910619500552172,6925,23,6948,0.9966896948762234,0.0033103051237766,23203970
93445,909,7312,880,2024,425200.0,67228.5,5415024,10310,8192,0.0,9.342045454545454,4.061758893280633,6.324698602527202,38251.67690257126,525.2205625606208,0.107421875,0.892578125,2024,0,2024,1.0,0.0,$                                   -
93446,7334,53477,6941,14613,502500.0,73006.5,52072481,69105,60418,0.0,8.76112952024204,4.1614316019982205,6.882948778533418,44872.867435312335,753.5269662108386,0.1148829818928134,0.8851170181071866,14437,176,14613,0.98795592965168,0.0120440703483199,159305296
93449,2018,14877,1928,4159,771400.0,89398.0,16538994,21684,16805,0.0,8.762966804979254,4.062274585236835,8.628828385422493,67661.60041799732,762.7280022136138,0.1147277595953585,0.8852722404046415,4147,12,4159,0.997114691031498,0.002885308968502,26242571
93454,3409,30213,3399,8024,375900.0,67177.5,24419636,42919,33612,0.0,9.891732862606649,4.190179461615155,5.5956235346656245,33818.87835315075,568.9702928772805,0.1011245983577293,0.8988754016422706,7962,62,8024,0.992273180458624,0.0077268195413758,46233178
93455,6493,50451,6154,13577,452600.0,91474.0,46918458,66045,56605,0.0,9.25316867078323,4.194151874493629,4.947854035026347,39619.00606775588,710.4013627072451,0.1087183111032594,0.8912816888967405,13563,14,13577,0.9989688443691536,0.0010311556308462,17152834
93458,4381,32100,4092,8618,361300.0,59756.0,22188557,42314,36192,0.0,8.915200391006843,4.233116732420515,6.046254769395542,32851.353205532774,524.3786217327598,0.1130636604774535,0.8869363395225465,8615,3,8618,0.9996518913901136,0.0003481086098862,1297905
93460,804,6403,770,1764,962500.0,100031.75,12761194,8263,7173,0.0,9.35974025974026,4.0856009070294785,9.621945032452196,83599.38265363162,1544.377828875711,0.1073469956782378,0.8926530043217622,1654,110,1764,0.937641723356009,0.0623582766439909,210062731
93463,1286,8896,1194,2399,892900.0,98122.25,13211783,13042,10090,1.8333333333333333,8.527638190954773,4.244268445185494,9.099872862678954,77684.2156662181,1013.0181720595,0.1183349851337958,0.8816650148662042,2377,22,2399,0.9908295122967904,0.0091704877032096,39469937
93465,1615,11232,1379,3163,763200.0,97355.75,13567992,14643,12611,0.0,9.316171138506164,4.061650331963326,7.839290437390703,66445.37319360395,926.5855357508708,0.1093489810482911,0.8906510189517088,3130,33,3163,0.989566866898514,0.0104331331014859,40522450
93501,774,4122,721,1252,120300.0,39463.25,3573353,5442,4843,0.0,6.790568654646324,3.910543130990415,3.0484057952652153,11367.152748411405,656.624954061007,0.1488746644641751,0.8511253355358249,1235,17,1252,0.9864217252396166,0.0135782747603833,5064617
93505,3046,13858,2832,4099,169100.0,47425.0,11996546,18074,16690,0.0,5.968926553672317,4.123932666504025,3.5656299420137056,15705.53499104202,663.746044041164,0.1696824445775913,0.8303175554224086,4078,21,4099,0.9948767992193218,0.0051232007806782,5310111
93510,1462,8242,1495,2355,589000.0,105770.75,16408847,10544,9737,2.125,6.490969899665552,4.120594479830149,5.5686472867026096,50911.790866213305,1556.2260053110774,0.1535380507343124,0.8464619492656876,2085,270,2355,0.8853503184713376,0.1146496815286624,211748662
93513,268,2195,242,586,269600.0,55384.25,2092592,2613,2437,0.0,10.177685950413224,4.203071672354949,4.86780989180137,24684.009573504383,800.8388825105243,0.0993024210094378,0.9006975789905621,584,2,586,0.9965870307167236,0.0034129692832764,461998
93514,1673,15761,1591,4295,337700.0,63542.25,16239390,19680,17352,1.4,10.95788812067882,4.059138533178114,5.314574161286388,30534.943866252557,825.172256097561,0.0916897187644075,0.9083102812355924,4265,30,4295,0.9930151338766008,0.0069848661233993,21520477
93518,202,1570,243,460,235800.0,44506.25,2665833,2068,1813,0.0,7.292181069958848,3.8521739130434782,5.298132284791462,22030.413932857384,1289.0875241779495,0.1340319911748483,0.8659680088251517,349,111,460,0.758695652173913,0.2413043478260869,45439748
93523,214,1131,259,357,81200.0,63029.0,1657782,3578,1390,0.0,5.193050193050193,3.76750700280112,1.288295863808723,7347.518484725694,463.3264393515931,0.1863309352517985,0.8136690647482014,353,4,357,0.988795518207283,0.011204481792717,931213
93526,115,1085,107,309,223500.0,48015.75,950307,1256,1192,1.4,11.214953271028037,3.883495145631068,4.654722669124194,20734.215047448604,756.6138535031847,0.0897651006711409,0.910234899328859,305,4,309,0.9870550161812298,0.0129449838187702,1289267
93532,495,2952,562,958,318700.0,71127.0,4991356,4454,3514,0.0,6.133451957295374,3.5981210855949897,4.480717589663559,28526.10624027978,1120.6457117198024,0.159931701764371,0.8400682982356289,598,360,958,0.6242171189979123,0.3757828810020877,192093979
93534,5301,29394,5218,8188,257600.0,42891.25,27909583,47452,34612,2.125,6.649099271751629,4.237298485588666,6.005886981610469,24150.551414275204,588.1645241507207,0.1507569629030394,0.8492430370969606,8136,52,8188,0.9936492427943332,0.0063507572056668,22076061
93535,11097,61124,10576,17134,241800.0,47848.25,54904819,77035,71700,2.125,6.828763237518911,4.215069452550485,5.053476354934611,22439.190440655228,712.7256312065944,0.1475034867503486,0.8524965132496514,16997,137,17134,0.9920042021711216,0.0079957978288782,55813082
93536,12300,69208,11727,19127,377300.0,82507.75,86304139,89492,80935,2.125,6.950456212159973,4.261410571443509,4.5729037575258085,33328.48229366262,964.3782572743931,0.1448940507814913,0.8551059492185087,19024,103,19127,0.9946149422282636,0.0053850577717362,53367347
93543,1953,12015,1937,3325,266000.0,54800.0,11328280,14177,13952,2.125,7.21115126484254,4.200902255639098,4.854014598540146,24378.07169176307,799.0604500246878,0.1388331422018348,0.8611668577981652,3267,58,3325,0.9825563909774436,0.0174436090225563,25888305
93545,281,2117,303,586,197600.0,40847.75,2055439,2544,2420,0.0,7.914191419141914,4.092150170648464,4.837475748358233,18610.59649716325,807.9555817610063,0.1252066115702479,0.8747933884297521,574,12,586,0.9795221843003412,0.0204778156996587,6711121
93546,1515,12523,1558,3293,493800.0,69244.5,33039222,34467,14081,0.0,9.010269576379974,4.262982083206802,7.131252301626844,44305.27790578797,958.575507006702,0.1106455507421348,0.8893544492578652,3029,264,3293,0.9198299423018524,0.0801700576981475,304843129
93550,9125,55448,9049,15401,280900.0,47572.0,48400374,69623,64497,2.125,7.135926621726157,4.192779689630544,5.904733877070545,26081.70934095227,695.1779440702066,0.1403010992759353,0.8596989007240647,15199,202,15401,0.9868839685734692,0.0131160314265307,82566463
93551,10272,56766,10077,15833,410900.0,94343.25,79305572,71916,66843,2.125,6.6525751711818994,4.234068085643909,4.355372535925993,35871.75387742133,1102.7528227376383,0.1507562497194919,0.849243750280508,15572,261,15833,0.9835154424303668,0.016484557569633,195644965
93552,5473,34563,5357,9705,324500.0,67088.0,33532545,39993,39920,2.125,7.473585962292328,4.125296239052035,4.836930598616743,29198.037954223695,838.4603555622234,0.134193386773547,0.8658066132264529,9631,74,9705,0.992375064399794,0.007624935600206,34850695
93553,330,2084,373,572,288800.0,58035.75,2613336,2590,2457,2.125,6.471849865951743,4.22027972027972,4.976243091542713,26329.18995522193,1009.0100386100386,0.1518111518111518,0.8481888481888482,553,19,572,0.9667832167832168,0.0332167832167832,8348180
93561,7882,37404,7625,10895,295000.0,66971.0,45802853,49373,45029,0.0,5.9391475409836065,4.156585589720055,4.404891669528602,26547.840407605545,927.6902963158,0.1693353172400009,0.8306646827599992,10042,853,10895,0.9217072051399724,0.0782927948600275,574818295
93562,227,1392,261,362,57600.0,38301.0,1093056,1712,1653,1.7142857142857142,6.203065134099617,4.472375690607735,1.5038771833633586,5458.043934341008,638.4672897196261,0.1578947368421052,0.8421052631578947,359,3,362,0.9917127071823204,0.0082872928176795,1751837
93591,1103,6426,1079,1817,207200.0,49088.75,5247943,7592,7505,2.125,6.977757182576459,4.143643368189323,4.220926383336304,19182.72488829792,691.2464436248683,0.1437708194536975,0.8562291805463025,1793,24,1817,0.9867914144193726,0.0132085855806274,8795868
93601,392,2444,394,729,327800.0,64707.0,4561382,3201,2838,1.5,7.197969543147208,3.890260631001371,5.065912497875036,29591.18131141457,1424.986566697907,0.138830162085976,0.8611698379140239,541,188,729,0.7421124828532236,0.2578875171467764,136129173
93602,778,3299,816,1100,291300.0,65077.5,8153780,5408,4115,0.0,4.9963235294117645,3.706363636363637,4.476201452114786,26282.704838986225,1507.7255917159764,0.1982989064398542,0.8017010935601458,631,469,1100,0.5736363636363636,0.4263636363636364,277837430
93608,83,302,45,138,154600.0,37705.25,273407,391,347,0.0,8.555555555555555,2.789855072463768,4.100224769760179,14671.335576414142,699.2506393861893,0.1296829971181556,0.8703170028818443,136,2,138,0.9855072463768116,0.0144927536231884,370225
93609,415,2871,409,791,206000.0,49328.25,2608274,3609,3280,0.0,8.034229828850856,4.154235145385588,4.176105983893611,19063.038307814822,722.7137711277362,0.1246951219512195,0.8753048780487804,785,6,791,0.9924146649810368,0.0075853350189633,3556271
93611,6595,52080,6361,13863,365400.0,95791.5,52518889,65020,58441,0.0,9.224178588272284,4.232489360167352,3.81453469253535,31857.214858178737,807.7343740387573,0.1088448178504816,0.8911551821495183,13860,3,13863,0.9997835966241072,0.0002164033758926,3155149
93612,3609,26337,3457,7215,243900.0,46370.25,22113949,41602,29794,0.0,8.66242406711021,4.15051975051975,5.259837934882818,22700.169067258837,531.5597567424643,0.1160300731690944,0.8839699268309056,7211,4,7215,0.9994455994455994,0.0005544005544005,2037839
93614,2723,15047,2807,4360,307300.0,71294.5,23635766,18649,17854,1.5,6.330602066262914,4.075688073394495,4.31029041510916,27499.928607941816,1267.4012547589682,0.1572196706620365,0.8427803293379634,3617,743,4360,0.8295871559633028,0.1704128440366972,559129155
93615,357,2902,338,805,171900.0,44931.75,1995936,3426,3240,0.0,9.642011834319527,4.048447204968944,3.825802467075064,16046.075366123569,582.584938704028,0.1043209876543209,0.895679012345679,801,4,805,0.9950310559006212,0.0049689440993788,733469
93616,174,1265,157,344,198000.0,40524.25,1099422,1560,1422,0.0,9.165605095541402,4.183139534883721,4.885963342936637,18662.245316748187,704.7576923076923,0.110407876230661,0.8895921237693389,342,2,344,0.994186046511628,0.005813953488372,1000500
93618,2943,20823,2540,5902,237000.0,46259.5,15236630,25191,23363,0.0,9.356692913385826,4.026770586241952,5.123271976566976,22062.88510602825,604.8441903854551,0.1087189145229636,0.8912810854770363,5897,5,5902,0.9991528295493052,0.0008471704506946,2523526
93619,11060,53999,8029,16596,452500.0,119386.0,60784208,64631,62028,0.0,8.103001619130652,3.9201614846951074,3.790226659742349,38707.90955120875,940.4806981170028,0.1294415425291803,0.8705584574708196,16496,100,16596,0.9939744516751025,0.0060255483248975,102466836
93620,1144,7542,1069,2097,267700.0,45636.0,5790659,8800,8611,0.0,8.12535079513564,4.1421077730090605,5.8659829958804455,24952.34131304405,658.0294318181818,0.1241435373359656,0.8758564626640344,2094,3,2097,0.9985693848354792,0.0014306151645207,1492911
93622,744,5108,624,1541,185900.0,39633.25,4263609,5864,5732,0.0,9.378205128205128,3.7975340687865025,4.690506077598986,17558.568110481923,727.0820259208731,0.1088625261688764,0.8911374738311235,1533,8,1541,0.9948085658663206,0.0051914341336794,3336379
93625,975,5852,783,1765,298100.0,58152.75,5615752,7541,6635,0.0,8.719029374201789,3.867988668555241,5.126154825008276,27172.05919355653,744.6959289218936,0.1180105501130369,0.881989449886963,1761,4,1765,0.9977337110481588,0.0022662889518413,1458606
93630,1840,12248,1546,3459,262200.0,53770.5,10956496,14741,13794,0.0,9.11254851228978,4.07285342584562,4.876279744469551,24071.65251014715,743.2668068652059,0.1120777149485283,0.8879222850514716,3441,18,3459,0.99479618386817,0.00520381613183,5949590
93635,6676,40520,5403,15339,343000.0,61872.25,33150047,47732,45923,0.0,8.735147140477512,3.076862898494035,5.5436807292445325,31089.03985420491,694.5036244029163,0.1176534634061363,0.8823465365938636,15334,5,15339,0.9996740335093552,0.0003259664906447,2282180
93636,3670,14365,2136,5348,375000.0,91973.75,16757473,16355,16501,1.5,8.443352059925093,3.3722887060583395,4.077250302396064,32810.52750301666,1024.608560073372,0.1294467001999878,0.8705532998000122,5336,12,5348,0.9977561705310396,0.0022438294689603,8744931
93637,4819,29841,4065,8763,275900.0,59356.0,27969146,36399,33906,1.5,8.526445264452645,3.95526646125756,4.648224273872902,25101.651932329376,768.4042418747767,0.1198902849053265,0.8801097150946735,8749,14,8763,0.9984023736163414,0.0015976263836585,7039919
93638,4850,33629,4612,9191,239700.0,47090.0,28300669,38575,38241,1.5,8.34323503902862,4.186595582635187,5.090252707581228,22277.332741053833,733.6531173039533,0.1206035407023874,0.8793964592976126,9165,26,9191,0.9971711456859972,0.0028288543140028,10961324
93640,950,6065,749,1719,204600.0,33618.75,4431720,6725,6814,0.0,9.365821094793056,4.0808609656777195,6.085889570552148,19629.967954336065,658.9918215613383,0.1099207513941884,0.8900792486058116,1709,10,1719,0.9941826643397323,0.0058173356602675,1436607
93643,625,3321,657,1197,237800.0,59924.5,7829286,5016,3978,0.0,6.006088280060883,3.2965747702589807,3.968326811237474,21616.52969530241,1560.8624401913876,0.1651583710407239,0.834841628959276,644,553,1197,0.5380116959064327,0.4619883040935672,339070884
93644,2010,10811,2073,3389,301300.0,55864.5,19058130,14761,12884,1.5,6.184756391702846,3.78312186485689,5.393407262214823,27564.60520839019,1291.1137456811869,0.1608972368829556,0.8391027631170443,2579,810,3389,0.7609914429035114,0.2390085570964886,529230334
93647,771,6067,768,1658,167400.0,40588.25,4396138,7163,6835,0.0,8.903645833333334,4.124246079613993,4.124346331758575,15775.73368554866,613.728605332961,0.1123628383321141,0.8876371616678859,1644,14,1658,0.991556091676719,0.008443908323281,4516886
93648,1060,8548,964,2332,186100.0,37920.75,6222224,10614,9512,0.0,9.966804979253112,4.1200686106346485,4.907603357001114,17651.097534370452,586.2280007537215,0.1013456686291,0.8986543313708999,2332,0,2332,1.0,0.0,$                                   -
93650,434,3202,430,916,192600.0,36449.75,2171664,4424,3632,0.0,8.455813953488372,3.96943231441048,5.2839868586204295,18336.41341511003,490.88245931283905,0.1183920704845815,0.8816079295154186,907,9,916,0.990174672489083,0.009825327510917,657526
93651,356,1770,344,522,366400.0,98802.5,3402731,2269,2114,0.0,6.180232558139535,4.0727969348659006,3.708408188051922,31858.43672462008,1499.661084178052,0.162724692526017,0.8372753074739829,445,77,522,0.8524904214559387,0.1475095785440613,57108567
93653,178,1087,163,337,443500.0,80311.25,1890614,1377,1250,1.5,7.760736196319019,3.753709198813056,5.522264937975688,39269.80306238811,1372.9949164851123,0.1304,0.8696,276,61,337,0.8189910979228486,0.1810089020771513,39896192
93657,3942,30457,3661,8120,307100.0,58976.75,27711900,35727,34118,0.0,9.396066648456706,4.236330049261084,5.207136710652927,27956.56216900244,775.657066084474,0.1073040623717685,0.8926959376282314,8090,30,8120,0.996305418719212,0.0036945812807881,22694808
93660,201,1872,218,535,207900.0,36897.75,1544257,2172,2090,0.0,9.509174311926603,3.8747663551401863,5.634489907921215,19770.051473919684,710.9838858195212,0.1043062200956937,0.8956937799043062,534,1,535,0.9981308411214952,0.0018691588785046,154072
93662,2783,21756,2761,5720,216900.0,44502.75,16324104,26528,24517,0.0,8.887721839913075,4.290034965034965,4.873856110015673,20264.76629278351,615.3537394451146,0.1126157360199045,0.8873842639800954,5712,8,5720,0.9986013986013986,0.0013986013986013,2542663
93667,341,2270,370,694,283300.0,66025.75,3905909,3098,2640,0.0,7.056756756756757,3.762247838616714,4.29075019973268,25527.58182146578,1260.7840542285346,0.1401515151515151,0.8598484848484849,509,185,694,0.7334293948126801,0.2665706051873199,115889930
93675,583,3960,674,1088,240800.0,65903.0,5386883,4884,4634,0.0,6.740356083086054,4.1755514705882355,3.6538549079708056,21701.63288812668,1102.9653972153972,0.1454466983167889,0.8545533016832111,958,130,1088,0.8805147058823529,0.119485294117647,72829709
93701,846,4358,827,1346,164100.0,23558.5,3472778,5833,5185,0.0,6.292623941958888,3.8662704309063898,6.965638729121124,16300.3929490682,595.3673924224241,0.1594985535197685,0.8405014464802314,1317,29,1346,0.9784546805349182,0.0215453194650817,4526483
93702,3913,24607,3713,7005,159800.0,29157.5,17780579,29941,28320,0.0,7.681120387826556,4.071377587437545,5.480579610734802,15544.04026854854,593.8538792959487,0.1311087570621469,0.8688912429378531,6888,117,7005,0.9832976445396144,0.0167023554603854,17522269
93703,3316,22012,3182,6101,183200.0,33113.75,16558678,27171,25194,0.0,7.9597737272155875,4.151450581871824,5.532444981314408,17602.345537511454,609.4246807257738,0.1262999126776216,0.8737000873223784,6072,29,6101,0.9952466808719882,0.0047533191280118,6551773
93704,3953,26306,3857,7215,291600.0,60182.5,28022627,36555,30163,0.0,7.845216489499611,4.193901593901594,4.845262327088439,26496.71720384375,766.5880727670633,0.1278718960315618,0.8721281039684382,7195,20,7215,0.9972279972279972,0.0027720027720027,5715577
93705,3851,27902,3741,7655,213400.0,42345.75,22110587,36083,31643,0.0,8.487837476610531,4.14800783801437,5.039466770573198,20030.74382981813,612.7701964914226,0.1182251998862307,0.8817748001137692,7644,11,7655,0.9985630306988896,0.0014369693011103,2617206
93706,2826,19208,2752,5338,186300.0,32189.75,15796768,23790,21960,0.0,8.006540697674419,4.127763207193706,5.787556597985383,17949.008587149707,664.0087431693989,0.1253187613843351,0.8746812386156648,5271,67,5338,0.9874484825777444,0.0125515174222555,13912033
93710,2732,21377,2691,5720,281800.0,52666.5,19632880,30900,24068,0.0,8.959123002601263,4.21486013986014,5.35064984382862,25920.426101308374,635.368284789644,0.1118082100714641,0.8881917899285359,5717,3,5720,0.9994755244755243,0.0005244755244755,685765
93711,5189,38801,5093,10434,398800.0,75583.25,53962534,54247,43894,0.0,8.637345376006284,4.216024535173472,5.27630129691433,35502.56884628439,994.756097111361,0.1160295256754909,0.883970474324509,10427,7,10434,0.9993291163503928,0.000670883649607,8571096
93720,6489,48526,6503,12999,370800.0,89848.0,53185252,69793,55029,0.0,8.45994156543134,4.232248634510347,4.1269699937672515,32509.56300525998,762.0427836602524,0.1181740536807865,0.8818259463192135,12998,1,12999,0.999923071005462,7.692899453804139e-05,171748
93721,112,674,119,231,181500.0,27039.5,1078083,3321,793,0.0,6.605042016806722,3.4025974025974026,6.712402226372529,17785.305134968734,324.6260162601626,0.1500630517023959,0.849936948297604,225,6,231,0.974025974025974,0.0259740259740259,1381509
93722,10753,71653,10239,19718,270900.0,61623.75,63935745,89313,81892,0.0,8.048246899111241,4.179227102140176,4.396032373881823,24562.956574522555,715.8615767021598,0.1250305280125042,0.8749694719874958,19700,18,19718,0.9990871285120196,0.0009128714879805,8166188
93723,2148,9943,1600,3309,374300.0,86701.75,10068981,12039,11543,0.0,7.556875,3.6539740102750073,4.317098559140963,32919.300796263946,836.3635684026913,0.1386121458892835,0.8613878541107165,3300,9,3309,0.99728014505893,0.0027198549410698,2849829
93725,2162,15582,1993,4348,226200.0,50172.25,12489780,18529,17575,0.0,8.903161063723031,4.080956761729531,4.508468326614812,20899.515586979545,674.0665983053592,0.1133997155049786,0.8866002844950214,4316,32,4348,0.9926402943882244,0.0073597056117755,5917661
93726,3954,27954,3932,7623,214600.0,42596.0,23602361,39803,31886,0.0,8.114954221770091,4.185753640299095,5.03803174006949,20132.246851177457,592.9794487852674,0.1233143072194693,0.8766856927805307,7618,5,7623,0.9993440902531812,0.0006559097468188,1560300
93727,10204,60776,8256,17878,287000.0,60018.5,53745941,77249,69032,0.0,8.597383720930232,3.970242756460454,4.7818589268308935,26085.1985026233,695.7493430335668,0.119596708772743,0.8804032912272569,17861,17,17878,0.999049110638774,0.000950889361226,5950094
93728,2124,13244,2037,3756,210500.0,38625.25,10692383,17287,15281,0.0,7.544428080510555,4.091586794462194,5.449802913896997,19930.57628912406,618.5216058309712,0.1333027943197434,0.8666972056802565,3718,38,3756,0.9898828541001063,0.0101171458998935,8512642
93901,2188,21799,2147,5582,569700.0,68865.5,22032804,33400,23946,1.6666666666666667,11.172333488588729,4.297205302758868,8.272647406901859,51140.44628849125,659.6647904191617,0.08966006848743,0.91033993151257,5578,4,5582,0.9992834109638122,0.0007165890361877,2932236
93905,3146,30069,2942,7902,444400.0,55476.5,22992487,37435,33011,1.6666666666666667,11.289938817131205,4.2033662363958495,8.01059908249439,40682.13137012952,614.1975958327769,0.089121807882221,0.9108781921177788,7899,3,7902,0.9996203492786636,0.0003796507213363,1029359
93906,4356,41737,4362,10901,466900.0,71997.25,37270842,59243,46099,1.6666666666666667,10.566941769830352,4.228327676359967,6.484969912045251,41745.70841618666,629.1180730212852,0.094622443003102,0.905377556996898,10899,2,10901,0.9998165305935236,0.0001834694064764,939092
93907,2504,21595,2538,5753,566800.0,83450.0,25646596,28452,24133,1.6666666666666667,9.495271867612294,4.188944898313923,6.792091072498502,50017.63620665751,901.3987065935612,0.1051671984419674,0.8948328015580326,5510,243,5753,0.957761168086216,0.0422388319137841,228813251
93908,1777,15218,1697,4103,846200.0,141809.75,27667584,19382,16915,1.6666666666666667,10.014731879787862,4.142091152815014,5.967149649442298,71335.58942743442,1427.4885976679393,0.1003251551877032,0.8996748448122968,3857,246,4103,0.9400438703387765,0.0599561296612234,349707403
93920,83,722,75,261,1081500.0,55624.5,3778593,1346,797,0.0,10.733333333333333,3.084291187739463,19.442871396596825,98980.64097582996,2807.2756315007427,0.0941028858218318,0.905897114178168,157,104,261,0.6015325670498084,0.3984674329501915,144155840
93923,2627,19644,2628,5815,1199000.0,102819.5,52780519,30078,22272,1.6666666666666667,8.474505327245053,3.829922613929493,11.661212124159327,103892.90526235742,1754.788184054791,0.1179956896551724,0.8820043103448276,5211,604,5815,0.8961306964746346,0.1038693035253654,909914440
93924,1095,8639,1092,2432,987100.0,118562.5,21279361,11947,9731,0.0,8.913919413919414,4.0024671052631575,8.325566684238272,84488.8710238615,1781.1468151000252,0.1122186825608878,0.8877813174391121,1955,477,2432,0.8038651315789473,0.1961348684210526,698007317
93926,513,5988,532,1565,453700.0,66759.0,4841540,6964,6520,1.6666666666666667,12.219924812030076,4.153993610223642,6.796087418924789,40841.331800072745,695.2240091901206,0.0815950920245398,0.91840490797546,1559,6,1565,0.9961661341853036,0.0038338658146964,4169825
93927,1256,11346,1150,3166,350400.0,61259.0,8546920,12943,12496,1.6666666666666667,10.958260869565216,3.9804169298799743,5.719975840284693,31788.46574089812,660.3507687553117,0.0920294494238156,0.9079705505761844,3113,53,3166,0.9832596336070752,0.0167403663929248,45055638
93930,1350,10351,1154,2900,336200.0,56128.75,8481270,12279,11505,0.0,10.13951473136915,4.034827586206896,5.989800236064405,30744.1789328992,690.7134131443929,0.1003042155584528,0.8996957844415472,2867,33,2900,0.9886206896551724,0.0113793103448275,31841746
93932,50,404,38,144,388100.0,51733.0,589788,531,442,1.6666666666666667,11.947368421052632,3.1527777777777777,7.501981327199273,35756.893517964825,1110.7118644067796,0.085972850678733,0.9140271493212668,136,8,144,0.9444444444444444,0.0555555555555555,4795214
93933,2807,17364,2059,5074,599700.0,71462.0,17043902,29819,19423,1.6666666666666667,9.796503156872268,3.9753646038628303,8.391872603621506,53655.205545600875,571.5785908313492,0.1060083406270916,0.8939916593729084,5065,9,5074,0.9982262514781236,0.0017737485218762,765792
93940,2917,28396,2868,7374,861000.0,86060.0,43948601,55873,31264,1.6666666666666667,10.918061366806135,4.246406292378627,10.004647920055776,75773.57689263302,786.580298176221,0.0917349027635619,0.908265097236438,7214,160,7374,0.978302142663412,0.021697857336588,297129339
93950,1940,19729,1868,5146,929200.0,88026.0,22765039,30790,21597,0.0,11.600107066381156,4.210843373493976,10.555972099152523,81613.38379071747,739.3646963299773,0.0864934944668241,0.913506505533176,5144,2,5146,0.9996113486202876,0.0003886513797123,2061971
93953,1196,8807,1296,2505,1418400.0,141786.75,30861216,11957,10103,0.0,7.718364197530864,3.993213572854291,10.00375564007215,119574.31294469556,2581.0166429706446,0.1282787290903692,0.8717212709096308,2452,53,2505,0.9788423153692616,0.0211576846307385,104805881
93955,2396,23348,2458,6119,588100.0,66978.75,20996259,38363,25806,1.6666666666666667,10.473555736371033,4.207223402516751,8.780396767631524,52924.143598560906,547.3049292286839,0.09524916686042,0.90475083313958,6118,1,6119,0.9998365746036936,0.0001634253963065,1568100
93960,1527,12874,1316,3560,432200.0,63128.5,9917153,15244,14190,1.6666666666666667,10.943009118541031,4.045224719101124,6.8463530734929545,39102.76220266662,650.5610732091315,0.0927413671599718,0.9072586328400282,3545,15,3560,0.9957865168539326,0.0042134831460674,17789268
94002,2366,25249,2347,6532,1678500.0,156323.75,35877047,39355,27596,0.0,11.766084363016615,4.227648499693815,10.737331979305768,140346.51216270184,911.6261466141532,0.0850485577619944,0.9149514422380056,6521,11,6532,0.9983159828536436,0.0016840171463563,14581294
94005,517,4400,471,1159,923800.0,114793.25,6223924,7479,4871,0.0,10.439490445859873,4.2424503882657465,8.047511504378525,79290.09384654062,832.1866559700495,0.0966947238760008,0.9033052761239992,1148,11,1159,0.9905090595340812,0.0094909404659188,14900533
94010,4031,40745,4076,13930,2000001.0,156748.5,104355763,61973,44821,0.0,10.985279685966631,3.2143575017946877,12.75929913204911,167190.64342669636,1683.8907750149258,0.0909395149595055,0.9090604850404944,13884,46,13930,0.996697774587222,0.0033022254127781,89182717
94014,3497,33069,3352,8854,865400.0,94989.75,36833188,48405,36421,0.0,10.908711217183772,4.1298847978314885,9.11045665453378,75504.7914755346,760.9376717281273,0.0920348150792125,0.9079651849207876,8840,14,8854,0.9984187937655296,0.0015812062344702,7833798
94015,4373,47537,4287,12401,932200.0,98365.75,52727790,78291,51824,0.0,12.108700723116398,4.18595274574631,9.47687584347194,81085.91486545239,673.4846917270185,0.0827222908305032,0.9172777091694968,12393,8,12401,0.999354890734618,0.0006451092653818,7420794
94019,1873,17043,1735,4492,1273400.0,134444.5,24617296,22631,18778,0.0,10.902593659942363,4.211041852181657,9.471566334063498,107833.86020275932,1087.7688126905573,0.0923953562679731,0.9076046437320268,4439,53,4492,0.9882012466607302,0.0117987533392698,58981084
94025,4042,39161,4016,10277,2000001.0,166552.0,69097721,62834,43177,0.0,10.757719123505977,4.203853264571373,12.00826768816946,166347.04689035958,1099.686809689022,0.0930124834981587,0.9069875165018412,10260,17,10277,0.9983458207648146,0.0016541792351853,13592747
94030,2137,21505,2129,5530,1606700.0,129186.25,28786073,31567,23634,0.0,11.104744011272896,4.275226039783002,12.43708211980764,136519.5492110723,911.9039820065258,0.09008208513159,0.90991791486841,5525,5,5530,0.9990958408679927,0.0009041591320072,5551180
94038,375,3517,412,988,995800.0,122996.5,4659476,4150,3929,0.0,9.446601941747574,3.9392712550607287,8.096165338038075,84966.51423542769,1122.7653012048193,0.1048612878595062,0.8951387121404938,986,2,988,0.9979757085020244,0.0020242914979757,3480192
94040,1835,19938,1804,5157,2000001.0,140364.5,27829847,49838,21742,0.0,12.069290465631928,4.222028311033546,14.248624117921556,168748.00507306008,558.4061760102733,0.0829730475577223,0.9170269524422776,5154,3,5157,0.9994182664339732,0.0005817335660267,1554996
94041,1027,9743,977,2607,1804400.0,144720.25,12345161,24249,10720,0.0,11.023541453428864,4.131185270425776,12.46819294466393,151852.82690404417,509.09979792981153,0.0911380597014925,0.9088619402985074,2607,0,2607,1.0,0.0,$                                   -
94043,1884,14728,1692,3894,1341300.0,142510.0,20974740,47915,16420,0.0,9.817966903073286,4.266050333846944,9.411971089748087,113026.12906263124,437.74893039757904,0.1030450669914738,0.8969549330085261,3893,1,3894,0.9997431946584489,0.0002568053415511,535570
94044,3455,40627,3343,10555,1012200.0,127452.5,48511745,57902,43970,0.0,13.186359557283875,4.1764092846991945,7.9417822325964575,86104.38381515749,837.8250319505371,0.0760291107573345,0.9239708892426656,10476,79,10555,0.992515395547134,0.0074846044528659,74011324
94061,3040,30546,3017,8058,1558300.0,117158.0,39868318,47346,33563,0.0,11.132250580046405,4.168031769669893,13.300841598525068,133515.79000320274,842.0630676297892,0.0898906533980871,0.9101093466019128,8055,3,8058,0.9996276991809382,0.0003723008190618,2474336
94062,3149,32155,3198,8406,2000001.0,181057.0,81045285,41998,35353,0.0,11.039399624765478,4.199857244825125,11.04625062825519,165199.67804478802,1929.741535311205,0.090459084094702,0.909540915905298,8239,167,8406,0.9801332381632168,0.0198667618367832,305359964
94063,1539,14945,1535,4051,1002400.0,80741.25,16657101,32389,16480,0.0,10.738762214983714,4.06911873611454,12.414967566144938,88715.7772736285,514.2826576924265,0.0931432038834951,0.9068567961165048,4039,12,4051,0.997037768452234,0.0029622315477659,3427516
94065,851,8737,874,2217,1545800.0,172529.25,15426616,21846,9611,0.0,10.97025171624714,4.324763193504736,8.959640176955501,128193.62358222198,706.1528884006225,0.0909374674851732,0.9090625325148268,2217,0,2217,1.0,0.0,$                                   -
94066,3449,37037,3311,9619,1027400.0,110537.0,44345674,61833,40348,0.0,12.227725762609484,4.208961430502131,9.294625329075332,88469.01394583531,717.1845778144357,0.08206106870229,0.91793893129771,9617,2,9619,0.9997920781786048,0.0002079218213951,2026087
94070,3175,32850,3151,8510,1910300.0,188572.75,49960737,48951,36001,0.0,11.432878451285308,4.233254994124559,10.13030779897944,157262.0721408142,1020.6275050560764,0.0875253465181522,0.9124746534818478,8485,25,8510,0.9970622796709752,0.0029377203290246,23134429
94080,4824,52865,4686,13784,963700.0,105471.75,59757145,79388,57551,0.0,12.31092616303884,4.185214741729541,9.13704380556879,83320.37586693646,752.7226407013654,0.081423433128877,0.918576566871123,13781,3,13784,0.9997823563551944,0.0002176436448055,3952240
94085,1221,9900,1138,2727,1217000.0,137006.0,11649411,31283,11038,0.0,9.772407732864677,4.078107810781078,8.882822650102915,102893.35784520498,372.3879103666528,0.1030983873890197,0.8969016126109802,2727,0,2727,1.0,0.0,468800
94086,2721,25059,2673,6644,1504000.0,144019.75,30757781,69116,27732,0.0,10.392817059483724,4.181216134858519,10.443012156318838,126623.78031667948,445.0167978470976,0.0963868455214193,0.9036131544785808,6640,4,6644,0.9993979530403372,0.0006020469596628,1512272
94087,4290,47216,4421,12169,1945100.0,165074.75,52424349,78111,51637,0.0,11.650305360778104,4.232558139534884,11.78314672595294,161900.70908957292,671.1519376272228,0.0856169026085946,0.9143830973914054,12168,1,12169,0.9999178239789628,8.217602103706138e-05,1196779
94089,2243,15155,2205,4546,338100.0,124737.75,15409027,32996,17360,0.0,7.890249433106576,3.827100747910251,2.710486600888665,28813.780350492023,466.9968177960965,0.127016129032258,0.8729838709677419,4546,0,4546,1.0,0.0,$                                   -
94102,203,2187,285,566,968000.0,49408.5,10645005,29964,2472,0.0,8.385964912280702,4.222614840989399,19.591770646751065,89564.2994960507,355.25981177412893,0.1152912621359223,0.8847087378640777,559,7,566,0.9876325088339224,0.0123674911660777,5256746
94103,317,3373,442,987,960000.0,78377.25,17463745,40487,3815,0.0,8.34841628959276,3.7386018237082066,12.248452197544568,85187.27323630007,431.3420357151678,0.1158584534731323,0.8841415465268676,963,24,987,0.9756838905775076,0.0243161094224924,10926823
94107,986,10176,1043,2429,1134600.0,162038.75,33624733,63447,11219,0.0,10.70182166826462,4.595306710580486,7.002028835695166,94584.7537242175,529.9656878969848,0.0929672876370443,0.9070327123629556,2418,11,2429,0.9954713874022232,0.0045286125977768,5081132
94108,74,682,96,246,1129100.0,63934.0,6708586,10860,778,0.0,7.875,3.073170731707317,17.66039978728063,102036.88264288072,617.733517495396,0.1233933161953727,0.8766066838046273,243,3,246,0.9878048780487804,0.0121951219512195,819680
94109,616,6242,677,1607,1171200.0,96478.5,44974811,75706,6919,0.0,10.129985228951256,4.267579340385812,12.139492218473546,102046.90241994674,594.07194938314,0.0978465096112155,0.9021534903887845,1591,16,1607,0.9900435594275048,0.0099564405724953,8858298
94110,3566,36317,3464,9386,1233600.0,135249.0,72178512,81152,39781,0.0,11.513568129330254,4.249200937566589,9.120954683583612,104410.77280919284,889.4236987381704,0.0870767451798597,0.9129232548201404,9288,98,9386,0.9895589175367568,0.0104410824632431,41610976
94111,33,290,53,59,1183200.0,127081.25,3913355,7265,343,0.0,6.09433962264151,5.47457627118644,9.310578861948557,100675.75002540264,538.6586373021336,0.1545189504373177,0.8454810495626822,59,0,59,1.0,0.0,155000
94112,6313,65093,6124,17081,1022100.0,100561.75,76252573,81665,71217,0.0,11.660026126714566,4.180434400796206,10.16390426777577,88735.30254358244,933.7240311026756,0.0859907044666301,0.9140092955333698,17048,33,17081,0.9980680288039342,0.0019319711960658,15537953
94114,2213,24302,2225,5836,1593400.0,162433.0,62202022,58391,26527,0.0,11.916853932584267,4.543351610692255,9.80958302807927,132805.2363693325,1065.267284341765,0.0838768047649564,0.9161231952350436,5803,33,5836,0.994345442083619,0.005654557916381,17054730
94115,975,9882,1031,2381,1515600.0,125357.25,57234018,49827,10913,0.0,10.530552861299707,4.5598488030239395,12.090246076712756,129108.9487298583,1148.6547052802698,0.0944744799780078,0.9055255200219922,2354,27,2381,0.988660226795464,0.0113397732045359,16176688
94116,4309,49649,4192,12930,1188000.0,119540.0,67412916,61943,53841,0.0,12.87166030534351,4.17308584686775,9.938096034800068,101613.09659780424,1088.3056358264855,0.0778588807785888,0.9221411192214112,12915,15,12930,0.9988399071925754,0.0011600928074245,12137972
94117,1305,14715,1350,3414,1478600.0,166127.0,48063467,55357,16065,0.0,11.866666666666667,4.69244288224956,8.900419558530523,123006.45033366513,868.2455154722979,0.0840336134453781,0.9159663865546218,3367,47,3414,0.986233157586409,0.013766842413591,29487400
94118,2006,22654,1983,6091,1609400.0,125776.0,71791615,50600,24637,0.0,12.4357034795764,4.048596289607618,12.795763897722937,137060.52309904402,1418.8066205533596,0.0804886958639444,0.9195113041360556,6064,27,6091,0.9955672303398456,0.0044327696601543,30487855
94121,2686,31216,2675,10067,1506400.0,105578.75,63863648,52480,33891,0.0,12.673644859813084,3.367636833217443,14.268022684489068,130230.16678914984,1216.914024390244,0.0789295093092561,0.921070490690744,10054,13,10067,0.9987086520313896,0.0012913479686103,14993839
94122,4237,50465,4208,13360,1239600.0,121133.75,76386683,77989,54673,0.0,12.999524714828896,4.094461077844311,10.233316478685753,105906.62155110003,979.4545769275154,0.0769666928831415,0.9230333071168584,13338,22,13360,0.9983532934131736,0.0016467065868263,10340060
94123,1211,11637,1240,2838,2000001.0,170930.75,53963729,45378,12877,0.0,10.361290322580643,4.5271317829457365,11.70065070211182,165988.77186706464,1189.2046586451584,0.0962957210530403,0.9037042789469596,2813,25,2838,0.9911909795630726,0.0088090204369274,28073321
94124,2375,21217,2323,5684,873900.0,63396.5,26438341,32810,23540,0.0,10.155832974601807,4.150598170302604,13.784672655430503,79034.73306788433,805.8013105760439,0.0986830926083262,0.9013169073916736,5648,36,5684,0.9936664320900774,0.0063335679099225,20014818
94127,2502,26210,2497,6768,1572100.0,171917.0,48528060,31486,28707,0.0,11.498598317981578,4.242316784869977,9.144529045993124,130413.13775804176,1541.2583370386835,0.086982269132964,0.913017730867036,6764,4,6768,0.9994089834515366,0.0005910165484633,3207896
94131,2519,26692,2527,6795,1458500.0,160870.75,49144001,48183,29219,0.0,11.5595567867036,4.298896247240618,9.066284579390596,121659.71180229864,1019.9448145611524,0.0864848215202436,0.9135151784797564,6778,17,6795,0.9974981604120676,0.0025018395879323,14131436
94132,1743,17985,1732,4662,1171000.0,83772.0,26580890,35294,19717,0.0,11.390300230946885,4.231660231660232,13.978417609702523,103300.55322592377,753.1277270924237,0.0878429781406907,0.9121570218593092,4653,9,4662,0.998069498069498,0.0019305019305019,6636603
94133,514,5772,593,1618,1393700.0,69013.25,23554186,26460,6365,0.0,10.60033726812816,3.88504326328801,20.19467276211452,125084.65905399638,890.1808767951625,0.0931657501963864,0.9068342498036136,1592,26,1618,0.9839307787391842,0.0160692212608158,16070659
94134,2971,30963,2953,8083,925900.0,82522.5,33908318,40691,33916,0.0,11.491364713850322,4.198193739948039,11.219970311127268,81787.31645005516,833.3124769605072,0.0870680504776506,0.9129319495223494,8066,17,8083,0.9978968204874428,0.0021031795125572,8305836
94301,1436,16127,1456,4194,2000001.0,166770.75,36879745,27279,17583,0.0,12.0625,4.1876490224129705,11.9925166733375,166328.88898564922,1351.9463690017965,0.0828072570096115,0.9171927429903884,4185,9,4194,0.9978540772532188,0.0021459227467811,13482270
94304,119,597,79,207,2000001.0,138535.5,3443464,6899,676,0.0,9.063291139240508,3.4589371980676327,14.43674004136124,168934.95675308403,499.1250905928396,0.1168639053254437,0.8831360946745562,202,5,207,0.9758454106280192,0.0241545893719806,7361413
94305,184,2526,196,643,2000001.0,61098.0,6416118,5600,2722,0.0,13.826530612244898,4.214618973561431,32.73431208877541,181484.43357349353,1145.735357142857,0.0720058780308596,0.9279941219691404,641,2,643,0.9968895800933126,0.0031104199066874,4976006
94306,2371,24436,2435,6290,2000001.0,159668.75,33287134,40834,26871,0.0,11.009034907597536,4.2618441971383145,12.52593885779152,166933.05502444194,815.1818092765833,0.0906181385136392,0.9093818614863608,6287,3,6290,0.9995230524642288,0.000476947535771,885499
94401,1928,18297,1867,4748,944300.0,95405.0,25144886,43202,20164,0.0,10.83288698446706,4.259688289806234,9.897804098317698,82357.34927187626,582.0306004351651,0.0925907558024201,0.9074092441975798,4741,7,4748,0.998525695029486,0.0014743049705139,4246810
94402,2317,25874,2334,6695,1882300.0,164573.5,43117998,40295,28208,0.0,12.07840616966581,4.21075429424944,11.437442844686418,156713.20961525373,1070.0582702568556,0.0827424844015882,0.9172575155984118,6683,12,6695,0.9982076176250934,0.0017923823749066,15574173
94403,3217,34553,3136,8906,1499300.0,137460.75,45586679,65499,37689,0.0,12.044005102040815,4.240961149786661,10.907113485122116,126725.39309695904,695.9904578695858,0.0832073018652657,0.9167926981347344,8905,1,8906,0.999887716146418,0.0001122838535818,1473950
94404,2190,22076,2140,5658,1404600.0,153734.25,36333665,61892,24216,0.0,11.3392523364486,4.2887946270767054,9.136545694924846,117608.83069427808,587.0494571188522,0.0883713247439709,0.9116286752560292,5656,2,5658,0.9996465182043124,0.0003534817956875,1618022
94501,4260,44246,4090,11672,969500.0,95619.75,67063354,84999,48336,0.0,11.859657701711493,4.155757368060315,10.139118749003211,84538.59569105893,788.9899175284415,0.084616021185038,0.915383978814962,11583,89,11672,0.99237491432488,0.0076250856751199,49797731
94502,1259,13083,1279,3312,978600.0,161648.0,19318130,21978,14362,0.0,11.213448006254886,4.330314009661835,6.053894882708106,81596.39835945124,878.975793975794,0.0890544492410527,0.9109455507589472,3312,0,3312,1.0,0.0,470279
94503,2311,19526,2276,5130,557800.0,106723.25,20936400,24614,21802,0.0,9.594463971880492,4.25672514619883,5.226602450731214,48177.60182482081,850.5890956366295,0.1043940922851114,0.8956059077148886,5129,1,5130,0.9998050682261208,0.0001949317738791,$                                   -
94508,310,2722,345,763,684400.0,100155.0,6507385,4028,3067,0.0,8.788405797101449,3.9737876802096985,6.8334082172632415,59438.232632358304,1615.5374875868918,0.1124877730681447,0.8875122269318553,601,162,763,0.7876802096985583,0.2123197903014416,261023282
94509,8370,62802,8075,16706,435600.0,66363.0,62688885,82686,70877,0.0,8.813869969040248,4.260265772776248,6.5638985579313776,39233.01102217355,758.1559756186053,0.113929765650352,0.8860702343496479,16667,39,16706,0.9976655093978212,0.0023344906021788,12858621
94510,2931,30346,2952,7822,628300.0,106767.5,37517559,46255,33298,0.0,11.27269647696477,4.254282792124776,5.884749572669586,54264.79648687285,811.1027780780456,0.0886539732116043,0.9113460267883956,7818,4,7822,0.9994886218358476,0.0005113781641523,4752380
94511,447,2525,376,765,433300.0,53657.5,3212172,3325,2901,0.0,7.904255319148936,3.884967320261438,8.075292363602479,39787.42136939312,966.0667669172932,0.1296104791451223,0.8703895208548776,738,27,765,0.9647058823529412,0.0352941176470588,12221418
94513,12029,73200,10582,20374,635600.0,112086.5,86798956,91428,83782,0.0,8.054148554148554,4.183223716501423,5.670620458306754,54665.74087896462,949.3695148094675,0.1263039793750447,0.8736960206249552,20354,20,20374,0.9990183567291646,0.0009816432708353,10776145
94517,1777,14801,1686,3994,815600.0,145786.5,23104058,19229,16487,0.0,9.832740213523133,4.1507260891337,5.594482342329365,68596.04393468579,1201.5215559831504,0.1022623885485534,0.8977376114514466,3968,26,3994,0.9934902353530296,0.0065097646469704,42727923
94518,3320,27351,3183,7222,649100.0,97535.75,31631404,40358,30534,0.0,9.6358781024191,4.246884519523678,6.654995732334042,56502.56394296311,783.770355319887,0.1042444488111613,0.8957555511888387,7198,24,7222,0.9966768208252562,0.0033231791747438,7568341
94519,2490,21725,2480,5739,608400.0,100017.5,20895517,28196,24205,0.0,9.764112903225806,4.219376197943893,6.082935486289899,52844.14938097692,741.0808979997163,0.1024581697996281,0.8975418302003718,5729,10,5739,0.9982575361561248,0.0017424638438752,4636979
94520,2633,20362,2664,5370,480300.0,64626.5,20880067,41317,23026,0.0,8.631756756756756,4.282122905027933,7.431935815803115,43362.54333115646,505.3626110317786,0.1156953009641275,0.8843046990358725,5365,5,5370,0.9990689013035382,0.0009310986964618,1605738
94521,4784,44069,4698,11594,649100.0,105030.0,52899007,65386,48767,0.0,10.398680289484886,4.213644988787304,6.180139007902504,56140.799763886,809.0265041446181,0.0963356368035762,0.9036643631964238,11589,5,11594,0.9995687424529928,0.000431257547007,5508677
94523,3693,33875,3676,8857,827200.0,120345.25,41649288,55868,37551,0.0,10.219804134929271,4.241616800270972,6.873557535507218,70712.21716167561,745.4945228037517,0.0978935314638757,0.9021064685361242,8847,10,8857,0.998870949531444,0.0011290504685559,6985592
94525,473,4213,463,1120,591000.0,84736.0,5126700,5700,4676,0.0,10.120950323974082,4.183928571428571,6.974603474320242,52082.89352656247,899.421052631579,0.0990162532078699,0.90098374679213,1105,15,1120,0.9866071428571428,0.0133928571428571,6748826
94526,4942,36927,4897,9789,1265000.0,158326.0,66412552,51970,41824,0.0,8.549928527670001,4.277147818980488,7.989843740131122,105659.5826478866,1277.9017125264577,0.1170858837031369,0.882914116296863,9765,24,9789,0.9975482684646032,0.0024517315353968,50174686
94530,2910,29447,2911,7697,891700.0,107592.5,38435677,39966,32358,0.0,11.115424252834078,4.203845654150968,8.28775239909845,76962.87112676211,961.7093779712756,0.0899622968044996,0.9100377031955004,7665,32,7697,0.9958425360530077,0.0041574639469923,30195550
94531,7028,44076,6289,12748,528200.0,103148.75,52775226,56075,50365,0.0,8.125934170774368,4.008785691873235,5.120760067378422,45755.65851125007,941.154275523852,0.1248684602402462,0.8751315397597538,12742,6,12748,0.9995293379353624,0.0004706620646375,4023721
94533,8777,64044,8014,17729,393700.0,73821.75,64120476,91511,72058,0.0,9.086723234339903,4.107451068870213,5.333116595041434,35122.28085773855,700.6859940335041,0.11121596491715,0.88878403508285,17724,5,17729,0.999717976197191,0.0002820238028089,4482888
94534,6232,45884,5773,12475,589000.0,115584.25,59573034,59997,51657,0.0,9.027542005889485,4.177635270541082,5.09584999686376,50524.30772453003,992.933546677334,0.1117563931316181,0.8882436068683818,12441,34,12475,0.9972745490981964,0.0027254509018036,57262803
94536,6641,53744,6547,14224,989600.0,127627.25,62364523,94132,60291,0.0,9.223308385520086,4.2452896512935885,7.753830001038179,84172.06863671813,662.5220222666044,0.1085900051417292,0.8914099948582708,14214,10,14224,0.99929696287964,0.0007030371203599,7327808
94538,5009,38791,4845,10409,888400.0,117191.25,41174033,81237,43636,0.0,9.040247678018575,4.20789701220098,7.580770748669376,76116.62966362687,506.8384233785098,0.1110321752681272,0.8889678247318727,10405,4,10409,0.9996157171678356,0.0003842828321644,2406677
94539,6363,50691,6041,13592,1548800.0,184209.0,67869123,67276,56732,0.0,9.444462837278596,4.197616244849912,8.407841093540489,127748.4489292476,1008.8162643438968,0.1064831135866882,0.8935168864133117,13585,7,13592,0.9994849911712772,0.0005150088287227,13722261
94541,5314,42365,5024,11545,641200.0,82490.0,47710062,70696,47389,0.0,9.490246815286625,4.129839757470767,7.773063401624439,56640.946212474184,674.8622552902568,0.1060161640887125,0.8939838359112874,11466,79,11545,0.9931572109138156,0.0068427890861844,27934720
94542,2118,13739,1991,3728,884200.0,116827.75,22346074,20517,15730,0.0,7.964339527875439,4.253487124463519,7.568407334729977,75776.95001501519,1089.1491933518546,0.1265734265734265,0.8734265734265734,3698,30,3728,0.9919527896995708,0.0080472103004291,33482333
94544,6079,48661,5915,13085,624800.0,85704.25,49850759,76096,54576,0.0,9.254437869822484,4.183416125334352,7.290186892715355,55006.49960404354,655.1035402649285,0.1083809733216065,0.8916190266783934,13068,17,13085,0.9987008024455484,0.0012991975544516,5942361
94545,3565,28247,3454,7525,664400.0,90863.5,27693573,38871,31701,0.0,9.210191082802549,4.227508305647841,7.312067001601303,58193.34201464921,712.4481747318052,0.1089555534525724,0.8910444465474275,7513,12,7525,0.998405315614618,0.001594684385382,3839754
94546,4801,43823,4757,11618,811300.0,100426.75,51221072,63169,48580,0.0,10.22156821526172,4.185229815803064,8.078524895010542,70442.56721953992,810.8577308489923,0.097920955125566,0.902079044874434,11601,17,11618,0.9985367533138234,0.0014632466861766,13531999
94547,2657,22532,2552,5950,590800.0,113071.75,28686768,35437,25084,0.0,9.870297805642632,4.23344537815126,5.225000939668838,50774.43102792762,809.5145751615543,0.1017381597831286,0.8982618402168713,5947,3,5950,0.9994957983193278,0.0005042016806722,2174690
94549,4068,32837,4095,8805,1547800.0,178459.75,71935645,43919,36932,0.0,9.012210012210012,4.191368540601931,8.673104159341252,128000.73182660136,1637.916277693026,0.1108794541319181,0.8891205458680819,8659,146,8805,0.983418512208972,0.0165814877910278,226552395
94552,1893,15617,1801,4198,1056100.0,169627.25,26774036,21074,17418,0.0,9.722376457523598,4.171033825631253,6.226004371349533,87706.04959784294,1270.4771756666985,0.1033987828682971,0.8966012171317028,4100,98,4198,0.9766555502620295,0.0233444497379704,113240416
94553,5796,54646,5697,14384,628400.0,104563.25,63565292,78256,60343,0.0,10.60944356678954,4.202030033370412,6.00975964308684,54371.39702706756,812.273717031282,0.0944102878544321,0.9055897121455678,14341,43,14384,0.9970105672969968,0.0029894327030033,38512144
94555,3887,31070,3791,8195,1078400.0,157000.25,32704021,48408,34861,0.0,9.221049854919546,4.265649786455156,6.868778871371224,90137.05773415342,675.5912452487192,0.1087461633343851,0.8912538366656149,8193,2,8195,0.9997559487492372,0.0002440512507626,1154945
94556,1887,16495,1860,4354,1224100.0,153050.75,32670506,24585,18355,0.0,9.882795698924731,4.221864951768489,7.998000663178717,102533.60577804418,1328.8796420581657,0.1013347861618087,0.8986652138381912,4331,23,4354,0.9947175011483692,0.0052824988516306,33311974
94558,7628,71224,7562,18914,693700.0,95455.0,100949270,99180,78786,0.0,10.427400158688178,4.168975362165591,7.267298727148918,60498.446089141085,1017.8389796329906,0.0959815195593125,0.9040184804406874,18587,327,18914,0.982711219202707,0.017288780797293,522307695
94559,2868,26084,2769,6965,704900.0,78119.5,29338381,40164,28853,0.0,10.455760202239077,4.15678391959799,9.023355244209192,62568.81890734293,730.4646200577632,0.0959692233043357,0.9040307766956642,6943,22,6965,0.9968413496051688,0.0031586503948312,47868323
94560,5686,39320,4808,11067,870200.0,124166.75,41453555,59885,44128,0.0,9.360648918469218,4.066684738411493,7.008317444082253,74189.76519824575,692.2193370627035,0.1089557650471356,0.8910442349528644,11060,7,11067,0.9993674889310564,0.0006325110689437,1863128
94561,7199,44808,5985,12881,501200.0,102481.25,46270612,54371,50793,0.0,8.689557226399332,4.037497088735346,4.890650728791853,43441.19764739378,851.0163874124073,0.1178311972122142,0.8821688027877858,12840,41,12881,0.9968170173123204,0.0031829826876795,13621202
94564,2098,20334,1989,5260,590900.0,100082.0,21846754,26679,22323,0.0,11.278029160382102,4.264638783269962,5.904158589956236,51321.26804805231,818.8745455226957,0.0891009272947184,0.9108990727052816,5253,7,5260,0.9986692015209124,0.0013307984790874,2912046
94565,10531,79032,9754,21536,442300.0,75522.25,78481369,112744,88786,0.0,9.182181669058847,4.158757429420505,5.8565522081240955,39377.92110358294,696.102400127723,0.1098596625594125,0.8901403374405875,21486,50,21536,0.9976783060921248,0.0023216939078751,16456253
94566,5771,44303,5612,11707,1195200.0,162697.5,68323051,63677,49915,0.0,8.922665716322166,4.277270009396088,7.346148527174664,99602.92228843994,1072.9627809099047,0.1124311329259741,0.8875688670740258,11695,12,11707,0.9989749722388316,0.0010250277611685,21047835
94567,81,527,66,240,383300.0,56416.25,1720063,1030,593,0.0,9.212121212121213,2.533333333333333,6.794141758801763,35034.92175709365,1669.964077669903,0.1112984822934232,0.8887015177065767,112,128,240,0.4666666666666667,0.5333333333333333,124977135
94568,8863,46646,7762,13437,983000.0,151554.5,65044406,95949,54408,0.0,7.15137851069312,4.131056039294485,6.486115555790161,82406.29344342698,677.9060334135843,0.1426628436994559,0.8573371563005441,13430,7,13437,0.99947905038327,0.0005209496167299,8621366
94572,998,8955,980,2380,546400.0,77239.5,8685562,11002,9935,0.0,10.156122448979591,4.181932773109244,7.074100686824746,48548.75188853898,789.4530085439011,0.0986411675893306,0.9013588324106694,2367,13,2380,0.9945378151260504,0.0054621848739495,3098192
94574,1222,9795,1247,2776,1295900.0,100963.0,28266189,14402,11042,0.0,8.834803528468324,3.9686599423631126,12.835395144756,112466.8208898687,1962.6572003888348,0.112932439775403,0.887067560224597,2530,246,2776,0.9113832853025936,0.0886167146974063,540462038
94577,4342,40911,4306,10732,667600.0,85065.0,44717041,60227,45217,0.0,10.509289363678588,4.216641818859486,7.848116146476224,58813.315647578806,742.4749863018247,0.0952296702567618,0.904770329743238,10709,23,10732,0.9978568766306374,0.0021431233693626,8455554
94578,3013,25510,2960,6803,633500.0,67810.0,26206436,42801,28470,0.0,9.636148648648648,4.192709098926944,9.342279899719806,56946.559005218834,612.2856008037195,0.1039690902704601,0.8960309097295399,6792,11,6803,0.998383066294282,0.001616933705718,4353907
94579,2542,22680,2549,5912,659600.0,88050.25,20871265,27794,25229,0.0,9.89486072969792,4.266238159675237,7.491176913183097,57932.50711094332,750.9269986327985,0.1010345237623369,0.898965476237663,5910,2,5912,0.999661705006766,0.0003382949932341,661396
94580,2981,28517,2924,7422,649600.0,95845.0,26476147,36254,31441,0.0,10.772229822161425,4.243869576933441,6.777609682299546,56632.29181329332,730.295884592045,0.092999586527146,0.907000413472854,7415,7,7422,0.9990568579897602,0.0009431420102398,2701040
94582,6547,35533,6034,9973,1153600.0,176175.5,54595498,63420,41567,0.0,6.973815048060988,4.2193923593703,6.5480160408229295,95502.72931877428,860.856165247556,0.1451632304472297,0.8548367695527702,9972,1,9973,0.9998997292690264,0.0001002707309736,$                                   -
94583,4509,36106,4282,9653,987300.0,155028.25,50864027,57585,40388,0.0,9.485053713218122,4.207500258986843,6.368516705826196,82609.82700949817,883.2860467135539,0.1060215905714568,0.8939784094285431,9618,35,9653,0.9963741841914432,0.0036258158085569,52766910
94585,3489,30100,3442,7859,419200.0,82320.25,29226179,38838,33542,0.0,9.75857059848925,4.273953429189464,5.092307178367412,37037.12732801813,752.5150368196097,0.1026176137380001,0.8973823862619998,7849,10,7859,0.9987275734826314,0.0012724265173686,5938858
94587,6399,56552,6359,14828,860300.0,117182.25,59864912,81750,62911,0.0,9.899512501965718,4.245414081467494,7.341555568356129,73709.55356880516,732.292501529052,0.1010793025067158,0.8989206974932842,14823,5,14828,0.999662800107904,0.000337199892096,3127713
94589,3206,28664,3178,7582,372000.0,70405.75,25425732,37079,31842,0.0,10.028319697923225,4.203376417831707,5.283659360208506,33327.270472879674,685.7178456808437,0.0998052886125243,0.9001947113874756,7572,10,7582,0.9986810867844896,0.0013189132155104,4534565
94590,4348,32842,4226,8844,381400.0,55048.0,31286589,49040,37068,0.0,8.80028395646001,4.2051108095884215,6.928498764714431,34939.6637279767,637.981015497553,0.1140066904068199,0.8859933095931801,8792,52,8844,0.9941203075531434,0.0058796924468566,18120246
94591,7005,58869,6775,15612,482700.0,88301.75,62028693,79628,65644,0.0,9.72309963099631,4.219446579554189,5.466482827350534,42384.80533263916,778.9809237956498,0.103208214002803,0.896791785997197,15584,28,15612,0.9982065078145016,0.0017934921854983,12050995
94592,252,1186,183,369,653700.0,143298.25,1435936,1666,1369,0.0,7.85792349726776,3.897018970189702,4.561814258024784,55059.162102473136,861.906362545018,0.1336742147552958,0.8663257852447042,369,0,369,1.0,0.0,$                                   -
94595,1264,10001,1277,2621,673500.0,78482.0,30019785,38967,11278,0.0,8.821456538762725,4.297977871041587,8.581585586503913,59757.11419825169,770.3899453383632,0.1132292959744635,0.8867707040255365,2598,23,2621,0.9912247233880198,0.0087752766119801,29294513
94596,1571,15767,1603,4041,1081800.0,113023.75,28303382,40724,17370,0.0,10.815970056144728,4.2905221479831726,9.571439631050996,92975.26052834892,695.0049602200177,0.0922855497985031,0.9077144502014968,4032,9,4041,0.9977728285077953,0.0022271714922048,9128571
94598,2946,27657,2932,7163,1050800.0,156313.0,44968556,44564,30589,0.0,10.437585266030014,4.272371911210387,6.72240952447973,87862.35507555703,1009.0780899380666,0.0958514498675994,0.9041485501324006,7152,11,7163,0.9984643305877424,0.0015356694122574,12026875
94599,417,3155,416,900,758600.0,67519.0,4561766,4901,3571,0.0,8.586538461538462,3.968888888888889,11.23535597387402,68218.41640613366,930.782697408692,0.1164939792775133,0.8835060207224867,895,5,900,0.9944444444444444,0.0055555555555555,14884005
94601,3344,26318,3225,7615,581800.0,51339.25,30918275,37580,29543,0.0,9.19751937984496,3.8952068286277086,11.332460057363518,53640.85285359317,822.7321713677488,0.1091629150729445,0.8908370849270555,7443,172,7615,0.9774130006565988,0.0225869993434011,51834144
94602,3275,30742,3232,8195,919900.0,102108.75,47530086,40994,33974,0.0,10.52506188118812,4.150945698596705,9.009022243441429,79756.93200912951,1159.4400643996682,0.095131571201507,0.9048684287984928,8117,78,8195,0.9904820012202562,0.0095179987797437,62404339
94603,3397,24805,3225,6899,447000.0,54784.0,24322326,31433,28030,0.0,8.744806201550388,4.087838817219887,8.159316588785046,40967.25443914944,773.7831578277606,0.1150552978951123,0.8849447021048876,6805,94,6899,0.9863748369328889,0.0136251630671111,27170395
94605,5460,40875,5262,11088,695000.0,75707.5,58222393,55435,46137,0.0,8.805587229190422,4.178841991341991,9.180068024964502,61862.28160047189,1050.2821863443671,0.1140516288445282,0.8859483711554718,10918,170,11088,0.9846681096681096,0.0153318903318903,124107237
94606,2038,16128,1896,4870,643100.0,59905.5,22306044,32671,18024,0.0,9.581223628691983,3.730184804928131,10.735241338441378,58460.85362919394,682.7475130849989,0.1051930758988016,0.8948069241011984,4768,102,4870,0.9790554414784394,0.0209445585215605,25921119
94607,1417,8102,1268,2439,640800.0,57898.75,17723709,31628,9370,0.0,7.507097791798107,3.902829028290283,11.067596450700576,58432.7596643325,560.3803275578601,0.135325506937033,0.864674493062967,2359,80,2439,0.96719967199672,0.03280032800328,26104063
94608,2497,17140,2331,4926,691300.0,93005.75,31096426,51670,19471,0.0,8.424281424281425,3.986398700771417,7.432873773933332,60426.12120522851,601.8274820979292,0.1197165014637152,0.8802834985362847,4846,80,4926,0.9837596427121396,0.0162403572878603,30149720
94609,1886,14947,1859,4180,937000.0,90563.0,24721454,29722,16806,0.0,9.054868208714362,4.027033492822967,10.346388701787706,82093.59864870446,831.7560729426015,0.1106152564560276,0.8893847435439723,4120,60,4180,0.985645933014354,0.0143540669856459,17206558
94610,1925,19426,1900,5076,1125700.0,104961.75,44998947,45049,21326,0.0,11.237368421052633,4.206264775413712,10.724859293980902,97367.51120380557,998.8889209527404,0.0890931257619806,0.9109068742380192,5052,24,5076,0.9952718676122932,0.0047281323877068,15535515
94612,207,1631,216,467,848500.0,57901.5,6637195,19646,1847,0.0,8.50925925925926,3.93576017130621,14.65419721423452,77372.00662426176,337.8395093148733,0.1169463995668651,0.8830536004331349,444,23,467,0.9507494646680942,0.0492505353319057,6540668
94618,1923,19332,1906,5078,1440300.0,166508.0,41820791,29607,21238,0.0,11.151626442812171,4.185703032690036,8.65003483316117,119797.3985667182,1412.530516431925,0.0897447970618702,0.9102552029381298,5067,11,5078,0.9978337928318236,0.0021662071681764,10711441
94619,2974,26856,2845,7182,790500.0,100193.5,40506611,34796,29701,0.0,10.48506151142355,4.1534391534391535,7.889733365936912,68650.43052502336,1164.1168812507185,0.0957880206053668,0.9042119793946332,7082,100,7182,0.9860763018657756,0.0139236981342244,106978089
94621,2920,19927,2658,5741,445600.0,42242.5,19883896,25386,22585,0.0,8.59556057185854,3.9796202752133776,10.548618097887198,41835.73200823459,783.2622705428189,0.1176887314589329,0.8823112685410671,5624,117,5741,0.9796202752133776,0.0203797247866225,33337385
94702,1664,16619,1648,4404,958700.0,82945.0,21861175,24279,18267,0.0,11.094053398058252,4.151453224341508,11.558261498583398,84646.44798809077,900.4149676675316,0.0902173318005145,0.9097826681994854,4382,22,4404,0.9950045413260672,0.0049954586739327,9543514
94703,1468,15378,1464,4126,1061200.0,85643.0,23738827,25360,16842,0.0,11.506830601092895,4.082888996606883,12.390971824901042,93432.41300476434,936.073619873817,0.0869255432846455,0.9130744567153544,4089,37,4126,0.9910324769752789,0.0089675230247212,14844727
94704,354,3570,353,984,787300.0,40788.0,8766699,15734,3923,0.0,11.11614730878187,3.987804878048781,19.30224575855644,74160.64244859265,557.1818355154443,0.0899821565128728,0.9100178434871272,958,26,984,0.9735772357723578,0.0264227642276422,32080263
94705,1340,13700,1271,3609,1420900.0,132221.25,37115057,20552,14971,0.0,11.833202202989773,4.167359379329454,10.746381538519715,120494.57709602904,1805.909741144414,0.084897468438982,0.915102531561018,3509,100,3609,0.972291493488501,0.027708506511499,169939064
94706,1437,16864,1415,4426,964500.0,103857.5,22052642,26770,18279,0.0,12.93356890459364,4.134884771802982,9.286763112919145,83500.89029858055,823.7819200597684,0.0774112369385633,0.9225887630614368,4419,7,4426,0.9984184365115228,0.0015815634884771,4376099
94709,388,4725,362,1197,1001900.0,74640.75,9842077,12195,5087,0.0,14.124309392265191,4.271512113617376,13.422962657797516,89292.38352504322,807.0583845838459,0.071161784942009,0.9288382150579908,1170,27,1197,0.9774436090225564,0.0225563909774436,11996208
94710,574,5018,558,1413,898500.0,88200.75,7223460,10399,5576,0.0,10.021505376344086,3.957537154989384,10.186988205882605,78903.2007556357,694.6302529089336,0.1000717360114777,0.8999282639885222,1388,25,1413,0.9823071479122436,0.0176928520877565,12635622
94801,2699,19647,2675,5451,475100.0,61757.5,20496300,28281,22322,0.0,8.353644859813084,4.099431297009723,7.692992753916529,43069.645702320246,724.7374562427071,0.1198369321745363,0.8801630678254637,5345,106,5451,0.9805540267840764,0.0194459732159236,34807193
94803,3197,27499,3163,7240,614700.0,93446.0,34074551,36143,30662,0.0,9.704710717673096,4.239779005524862,6.578130685101556,53708.390920603655,942.7704119746562,0.1031570021525014,0.8968429978474985,7192,48,7240,0.9933701657458563,0.0066298342541436,42287320
94804,4332,34557,4195,9347,526600.0,62645.0,35622069,51173,38752,0.0,9.270321811680573,4.160586284369316,8.406097852981084,47676.64990422138,696.1106247435171,0.1082524772914946,0.8917475227085053,9282,65,9347,0.9930458970792768,0.0069541029207232,21817207
94805,1716,16453,1695,4370,613400.0,87382.5,17362204,20009,18148,0.0,10.719174041297936,4.15766590389016,7.019712184934054,53910.81803461346,867.7197261232445,0.0933987216222173,0.9066012783777828,4342,28,4370,0.9935926773455378,0.0064073226544622,14241977
94806,4897,43514,4854,11474,479200.0,66711.5,42492268,63634,48368,0.0,9.973423980222496,4.2191912149206905,7.183169318633219,43139.56413067845,667.7604425307226,0.1003556070129011,0.8996443929870989,11395,79,11474,0.9931148683981176,0.0068851316018825,27723680
94901,3299,32613,3256,8555,1136000.0,95694.25,58959540,50089,35869,0.0,11.02948402948403,4.197779076563413,11.871141683016482,99050.35911102682,1177.0955698856037,0.0907747637235495,0.9092252362764504,8528,27,8555,0.9968439509059028,0.003156049094097,29799848
94903,2645,28248,2658,7263,940800.0,106768.0,43130608,46846,30906,0.0,11.622648607975922,4.2534765248519895,8.811628952495129,81254.65523790769,920.6892370746702,0.0860027179188507,0.9139972820811492,7250,13,7263,0.9982101060167976,0.0017898939832025,27562273
94904,1284,11854,1324,3078,1635600.0,137134.25,33504368,19814,13178,0.0,9.922960725075528,4.268356075373619,11.926998543398168,138273.67637526258,1690.9441808822046,0.1004704811048717,0.8995295188951282,3046,32,3078,0.9896036387264456,0.0103963612735542,56859323
94920,1583,14376,1676,3756,2000001.0,183209.25,48783729,23052,16052,0.0,9.522076372315036,4.248935037273696,10.91648483905698,165038.58629097498,2116.2471369078603,0.1044106653376526,0.8955893346623474,3741,15,3756,0.9960063897763578,0.0039936102236421,23178399
94924,189,2272,205,601,1119300.0,76176.0,3805216,2824,2477,0.0,12.004878048780489,4.0948419301164725,14.693604284814114,99574.74802441694,1347.456090651558,0.0827614049253128,0.9172385950746872,594,7,601,0.9883527454242927,0.0116472545757071,11506487
94925,983,10181,992,2678,1372500.0,158447.0,17650314,16755,11173,0.0,11.254032258064516,4.168782673637042,8.662202503045183,114631.24447225204,1053.435631154879,0.0887854649601718,0.9112145350398282,2650,28,2678,0.989544436146378,0.0104555638536221,41544196
94928,4664,36463,3767,10101,546100.0,74880.0,38370907,67813,40230,0.0,10.917706397663924,4.071577071577072,7.293002136752137,48656.220021254194,565.8340878592601,0.0936365896097439,0.906363410390256,10098,3,10101,0.9997029997029996,0.0002970002970002,3161763
94929,140,1083,132,283,1265000.0,148056.25,1722916,1402,1215,0.0,9.265151515151516,4.321554770318021,8.544049981003841,106254.77289835188,1228.8987161198288,0.1086419753086419,0.891358024691358,279,4,283,0.9858657243816256,0.0141342756183745,3454788
94931,1018,8828,904,2325,663100.0,84378.0,9829596,14643,9732,0.0,10.891592920353984,4.234838709677419,7.858683543103653,58458.64203052494,671.2829338250358,0.0928894369091656,0.9071105630908344,2325,0,2325,1.0,0.0,185000
94933,122,1159,117,269,879500.0,100091.25,1669863,1425,1276,0.0,10.948717948717947,4.762081784386617,8.78698187903538,76386.34784146246,1171.8336842105264,0.091692789968652,0.908307210031348,241,28,269,0.895910780669145,0.104089219330855,26794028
94937,230,2471,257,801,1007400.0,80688.25,6306195,3266,2728,0.0,10.509727626459144,3.3720349563046192,12.485089216831447,89163.47578982948,1930.8619105939988,0.094208211143695,0.905791788856305,597,204,801,0.7453183520599251,0.2546816479400749,264227477
94938,109,900,102,213,933600.0,106385.5,1618454,1149,1002,0.0,9.892156862745098,4.737089201877934,8.775632017521184,80657.8099289888,1408.5761531766757,0.1017964071856287,0.8982035928143712,190,23,213,0.892018779342723,0.107981220657277,24757284
94939,736,6918,728,1836,1697200.0,128249.0,15169596,13604,7646,0.0,10.513736263736265,4.168845315904139,13.23363145131736,144298.51299454956,1115.0835048515144,0.0952131833638503,0.9047868166361496,1813,23,1836,0.9874727668845316,0.0125272331154684,34570623
94941,3583,35006,3590,9299,1582800.0,162135.75,79181511,52660,38596,0.0,10.749025069637884,4.149801053876761,9.76219001669897,131941.90006041527,1503.636745157615,0.0930148201886205,0.9069851798113794,9046,253,9299,0.9727927734164964,0.0272072265835036,348065785
94945,1899,19406,1851,5102,909300.0,114170.25,28134148,26874,21257,0.0,11.509994597514856,4.175813406507252,7.964421554651934,78082.02427928863,1046.8909726873558,0.0870771980994496,0.9129228019005504,5090,12,5102,0.9976479811838496,0.0023520188161505,33276346
94946,79,768,78,221,1736600.0,115208.25,2433530,955,846,0.0,10.85897435897436,3.832579185520362,15.073573290107262,149006.86436765827,2548.198952879581,0.0921985815602836,0.9078014184397164,193,28,221,0.8733031674208145,0.1266968325791855,47580531
94947,2264,25259,2238,6432,851100.0,111535.0,36356228,38445,27497,0.0,12.298033958891867,4.279073383084577,7.630788541713364,73231.21120517602,945.6685654831576,0.0813906971669636,0.9186093028330364,6412,20,6432,0.9968905472636816,0.0031094527363184,23560037
94949,1743,14604,1724,3897,829100.0,96838.5,24917787,26348,16328,0.0,9.48201856148492,4.19476520400308,8.561677432013093,72216.22236007164,945.7183467435858,0.1055854973052425,0.8944145026947574,3880,17,3897,0.995637670002566,0.0043623299974339,25970172
94951,572,5216,526,1380,955000.0,97044.25,7095576,6828,5742,0.0,11.003802281368822,4.194202898550724,9.84087156116926,83166.98239383416,1039.1880492091389,0.0916057122953674,0.9083942877046324,1367,13,1380,0.9905797101449276,0.0094202898550724,25304710
94952,3480,36574,3294,9779,866200.0,92043.0,44928834,52271,39868,0.0,12.159684274438373,4.095919828203293,9.410818856404072,75782.95327372596,859.5365307723212,0.0826226547607103,0.9173773452392896,9745,34,9779,0.9965231618774926,0.0034768381225074,47552275
94954,3921,41070,3800,10641,661700.0,95288.0,44217517,58150,44870,0.0,11.839736842105264,4.228080067662813,6.944211233313744,57716.49994647435,760.4044196044712,0.0846891018497882,0.9153108981502116,10627,14,10641,0.9986843341791184,0.0013156658208814,17736517
94956,134,1647,155,465,1299500.0,73488.25,2722907,2174,1802,0.0,11.49032258064516,3.83010752688172,17.68309899881954,115976.2448358232,1252.4871205151794,0.086015538290788,0.913984461709212,434,31,465,0.9333333333333332,0.0666666666666666,37193196
94960,1901,19485,1996,5022,1308500.0,141932.25,34871255,25387,21481,0.0,10.714428857715433,4.258462763839108,9.21918732352936,110299.9583887332,1373.5870721235278,0.092919324053815,0.907080675946185,5002,20,5022,0.9960175228992432,0.0039824771007566,22475852
94965,965,8826,970,2594,1173700.0,110696.5,23520944,21154,9796,0.0,10.09381443298969,3.774479568234387,10.602864589214654,101054.30279374323,1111.891084428477,0.0990200081665986,0.9009799918334014,2268,326,2594,0.874325366229761,0.125674633770239,293815276
94970,232,2045,268,634,1593800.0,117387.25,5082220,2624,2313,0.0,8.496268656716419,3.591482649842271,13.577283733965997,136534.57625349407,1936.8216463414635,0.1158668396022481,0.8841331603977518,626,8,634,0.9873817034700316,0.0126182965299684,12441897
94973,237,2039,217,441,957400.0,93729.5,3344577,2455,2256,0.0,10.488479262672811,5.160997732426304,10.21450023738524,83629.09933017376,1362.353156822811,0.0961879432624113,0.9038120567375888,406,35,441,0.9206349206349206,0.0793650793650793,35221285
95002,212,1475,191,353,659100.0,99519.5,1343602,1909,1666,0.0,8.832460732984293,4.779036827195467,6.622822662895212,57272.65936154471,703.8250392875851,0.1146458583433373,0.8853541416566627,348,5,353,0.9858356940509916,0.0141643059490084,2119539
95003,3948,32902,3937,8935,935600.0,111262.0,49945568,47574,36839,0.0,9.35991871983744,4.1242305540011195,8.408980604339307,80518.8244784106,1049.8500861815278,0.1068704362224816,0.8931295637775184,8733,202,8935,0.9773922775601568,0.0226077224398433,223449486
95004,484,4315,503,1163,780500.0,111907.5,6353297,5285,4818,1.6666666666666667,9.54075546719682,4.1263972484952705,6.974510198154726,67137.31362211087,1202.137559129612,0.1044001660440016,0.8955998339559983,1137,26,1163,0.9776440240756664,0.0223559759243336,23030721
95005,934,8199,948,2225,804800.0,90007.75,11919233,10630,9147,0.0,9.63396624472574,4.104719101123596,8.941452263832836,70549.1425008289,1121.2825023518344,0.1036405378812725,0.8963594621187274,1998,227,2225,0.8979775280898876,0.1020224719101123,207011480
95006,1607,12444,1799,3303,646300.0,106187.0,19619106,17502,14243,0.0,7.810450250138966,4.254011504692704,6.086432425814836,55845.71010583327,1120.9636612958518,0.1263076599031103,0.8736923400968897,2828,475,3303,0.8561913412049652,0.1438086587950348,450097954
95008,4016,36094,3889,9460,1230900.0,122026.75,44114089,73025,39983,0.0,10.313705322705063,4.239957716701903,10.08713253446478,105097.37589008498,604.0957069496748,0.0972663381937323,0.9027336618062676,9458,2,9460,0.9997885835095136,0.0002114164904862,1021106
95010,998,10163,983,2666,760500.0,79116.0,11727652,18862,11146,0.0,11.354018311291965,4.1864216054013506,9.612467768845743,67428.16062785216,621.7607888877108,0.0881930737484299,0.91180692625157,2666,0,2666,1.0,0.0,164268
95012,646,6413,622,1699,486000.0,63577.5,5734800,8259,7035,1.6666666666666667,11.34887459807074,4.154796939376103,7.644213754866108,43942.07456466738,694.3697784235379,0.0884150675195451,0.9115849324804548,1688,11,1699,0.9935256032960564,0.0064743967039434,8465163
95014,5251,50041,5282,12997,2000001.0,176910.75,64495418,88384,55323,0.0,10.468004543733434,4.2542125105793644,11.305141151682417,165516.40208010637,729.7182521723389,0.0954756611174375,0.9045243388825625,12930,67,12997,0.9948449642225128,0.0051550357774871,138283660
95017,60,623,74,153,908100.0,66523.25,1187802,1009,697,0.0,9.22972972972973,4.4640522875816995,13.650866426399793,81771.71664005163,1177.207135777998,0.1061692969870875,0.8938307030129125,143,10,153,0.934640522875817,0.065359477124183,11364692
95018,1310,10293,1365,2851,657200.0,105854.0,13798963,13642,11658,0.0,8.5003663003663,4.069800070150825,6.208551400986264,56802.97735918614,1011.5058642427796,0.1170869788986104,0.8829130211013896,2476,375,2851,0.8684672044896528,0.1315327955103472,324519088
95019,298,3785,310,983,471700.0,53552.5,3084187,5149,4095,0.0,13.170967741935485,4.153611393692778,8.808178889874423,43321.26213299327,598.9875704020199,0.0757020757020757,0.9242979242979243,983,0,983,1.0,0.0,$                                   -
95020,7026,53719,6565,14631,815900.0,106075.0,67162187,69293,60284,0.0,9.252856054836252,4.151800970542,7.6917275512609,70506.9938599839,969.2492315241078,0.1089012009820184,0.8910987990179815,14569,62,14631,0.995762422254118,0.004237577745882,80846980
95023,7967,48117,5850,14217,609800.0,87616.0,52979463,60595,53967,0.0,9.587008547008548,3.9448547513540126,6.959915997078159,53581.852332423194,874.3207030283027,0.1083995775195953,0.8916004224804047,14178,39,14217,0.9972568052331716,0.0027431947668284,38912607
95032,3216,27065,3139,7059,1726700.0,151734.75,46118287,42567,30204,0.0,9.646702771583309,4.289701090806063,11.379726792972605,144737.30389759468,1083.428172058167,0.1039266322341411,0.8960733677658588,7000,59,7059,0.991641875619776,0.0083581243802238,118613862
95035,6020,49391,5923,13223,995200.0,135870.0,55507593,93201,55314,0.0,9.355225392537566,4.190501399077365,7.324648561124604,84200.16819022628,595.5686419673609,0.1070795820226344,0.8929204179773655,13216,7,13223,0.9994706193753308,0.0005293806246691,4704401
95037,6274,47012,5817,12656,954600.0,128504.5,68475320,65948,52829,0.0,9.16039195461578,4.210335018963337,7.428533631117976,81147.80568927227,1038.322921089343,0.1101099774744931,0.8898900225255069,12501,155,12656,0.9877528445006322,0.0122471554993678,178430346
95039,161,959,104,261,227500.0,44032.0,990007,1439,1063,0.0,10.76923076923077,4.291187739463601,5.166696947674419,21276.253650592644,687.9826268241835,0.0978363123236124,0.9021636876763875,260,1,261,0.9961685823754788,0.003831417624521,366095
95045,621,3752,483,1102,726500.0,86425.75,5734930,5015,4235,0.0,9.053830227743273,3.968239564428312,8.406059536654295,63912.85152011195,1143.555333998006,0.1140495867768595,0.8859504132231405,1077,25,1102,0.9773139745916516,0.0226860254083484,26675970
95046,604,5410,589,1454,1092500.0,121227.0,8661731,6709,5999,0.0,10.210526315789474,4.136176066024759,9.012018774695406,93332.83134298712,1291.061410046207,0.0981830305050841,0.901816969494916,1448,6,1454,0.9958734525447044,0.0041265474552957,8331985
95050,2675,24710,2648,6546,1140200.0,98763.75,26717950,51592,27358,0.0,10.34176737160121,4.183470821875955,11.54472162104011,99143.63693571962,517.870018607536,0.0967907010746399,0.90320929892536,6543,3,6546,0.9995417048579284,0.0004582951420714,1322517
95051,4495,41184,4459,10759,1253100.0,142705.75,44109744,87634,45643,0.0,10.24422516259251,4.245654800632029,8.781005670759587,105581.6460795532,503.3405299313052,0.0976929649672458,0.9023070350327542,10758,1,10759,0.999907054558974,9.294544102611768e-05,1143405
95054,1366,10758,1327,2866,1195700.0,157630.5,14533991,36330,12085,0.0,9.136397889977392,4.230286113049546,7.585460935542296,99908.01339109764,400.0548031929535,0.1098055440628878,0.8901944559371121,2866,0,2866,1.0,0.0,406350
95060,4310,44218,4359,11574,971100.0,82706.75,58756884,71093,48577,0.0,11.13282863041982,4.192846034214619,11.741484219849044,85763.06231201084,826.4791751649249,0.0897338246495254,0.9102661753504744,11343,231,11574,0.9800414722654224,0.0199585277345775,307251376
95062,3516,39128,3396,10448,840100.0,83324.75,41546295,60356,42524,0.0,12.557126030624264,4.081546707503828,10.082238470562467,74145.00093169749,688.3540161707203,0.0798607844981657,0.9201392155018344,10435,13,10448,0.9987557427258804,0.0012442572741194,5262025
95065,852,8636,878,2311,931400.0,108608.75,12758300,12285,9514,0.0,10.806378132118452,4.105581999134574,8.575736301172787,80324.21347221025,1038.5266585266586,0.0922850536052133,0.9077149463947868,2226,85,2311,0.963219385547382,0.0367806144526179,105284429
95066,2141,16604,2076,4549,920600.0,114615.5,27275595,23856,18680,0.0,9.029383429672446,4.120685865025281,8.032072450933775,79025.9475813133,1143.3431841046277,0.1111349036402569,0.8888650963597431,4331,218,4549,0.9520773796438776,0.0479226203561222,253590147
95070,4109,38105,4214,9907,2000001.0,198543.0,72617388,47919,42319,0.0,10.017560512577123,4.261027556273342,10.073389643553286,163951.15891065783,1515.4195204407438,0.0995770221413549,0.900422977858645,9779,128,9907,0.9870798425355808,0.012920157464419,224026597
95073,1504,12451,1481,3350,842800.0,95982.75,18042651,16831,13932,0.0,9.422687373396354,4.165671641791045,8.780744456686227,73466.3180415102,1071.9892460341036,0.1063020384725811,0.8936979615274189,3199,151,3350,0.9549253731343283,0.0450746268656716,153800316
95110,931,8611,935,2409,739600.0,100270.0,11042495,24313,9546,0.0,10.205347593582887,3.9609796596097966,7.376084571656527,64225.797889338646,454.1806852301238,0.0979467839932956,0.9020532160067044,2371,38,2409,0.9842258198422582,0.0157741801577418,13149214
95111,4555,35049,4256,9591,661700.0,75076.75,32110113,50260,39305,0.0,9.305451127819548,4.129287874048587,8.813647367527231,58942.12626514805,638.8800835654596,0.1082813891362422,0.8917186108637578,9568,23,9591,0.9976019184652278,0.0023980815347721,7464121
95112,3191,25662,2973,7113,823900.0,71811.0,30072588,57719,28635,0.0,9.70501177262025,4.056375650217911,11.473172633719068,73682.28010761375,521.0171347389941,0.1038239916186485,0.8961760083813515,7002,111,7113,0.9843947701391818,0.0156052298608182,36488764
95113,10,82,13,31,872000.0,128428.5,971629,4146,95,0.0,7.076923076923077,2.967741935483871,6.789770183409446,74129.94477678697,234.35335262904005,0.1368421052631579,0.8631578947368421,31,0,31,1.0,0.0,$                                   -
95116,2941,23223,2827,6480,687900.0,68379.25,20814665,36290,26050,0.0,9.255040679165193,4.037654320987654,10.060069392396086,61790.24810370885,573.5647561311656,0.1085220729366602,0.8914779270633397,6401,79,6480,0.9878086419753086,0.0121913580246913,21902777
95117,1613,14749,1607,3804,1141000.0,99801.25,17333223,30643,16356,0.0,10.18170504044804,4.301261829652997,11.43272253604038,99123.12962748788,565.650327970499,0.0982514062117877,0.9017485937882124,3802,2,3804,0.9994742376445848,0.0005257623554153,945503
95118,3191,30719,3196,8063,1111900.0,119250.5,31345014,45595,33915,0.0,10.610137672090111,4.20563065856381,9.324069920042264,95123.77022190524,687.4660379427569,0.094235588972431,0.9057644110275688,7961,102,8063,0.9873496217288852,0.0126503782711149,27941166
95119,1212,10231,1099,2730,950700.0,125227.75,10593799,14022,11330,0.0,10.412192902638765,4.191575091575092,7.5917677990700945,80994.11836039556,755.5126943374697,0.0969991173874669,0.9030008826125332,2730,0,2730,1.0,0.0,$                                   -
95121,3663,29656,3639,7793,838900.0,109554.5,28674842,39168,33295,0.0,9.156086837043144,4.275503657128192,7.6573760092009,72292.9312041688,732.0987030228758,0.10929569004355,0.8907043099564499,7780,13,7793,0.9983318362633132,0.0016681637366867,3511436
95122,3576,29841,3329,8140,674500.0,81860.25,24563414,40974,33170,0.0,10.038149594472817,4.105282555282555,8.239652334313663,59622.89265200406,599.4878215453703,0.1003617726861622,0.8996382273138378,8106,34,8140,0.9958230958230958,0.0041769041769041,13239751
95123,6342,54627,6158,14182,889800.0,119079.5,59473166,98519,60785,0.0,9.900779473855147,4.299041037935411,7.4723189129950995,76132.3166627512,603.672042956181,0.1013078884593238,0.8986921115406762,14175,7,14182,0.9995064165844028,0.0004935834155972,4007959
95124,5654,53426,5605,13967,1259000.0,155700.75,56429780,70729,59031,0.0,10.540588760035682,4.229970645092003,8.086023991535043,105305.49690487662,797.8308755955832,0.0949501109586488,0.9050498890413512,13964,3,13967,0.9997852079902628,0.0002147920097372,1448270
95125,6028,51740,6051,13579,1300600.0,121344.0,65954735,78852,57791,0.0,9.546851760039663,4.254216068929965,10.718288502109704,111101.76420632076,836.4370593009689,0.1047048848436607,0.8952951151563392,13558,21,13579,0.9984534943663008,0.001546505633699,12310586
95126,1989,17400,1929,4616,1011900.0,104128.5,25779043,50726,19329,0.0,10.051321928460345,4.200389948006932,9.717800602140624,87584.75122304528,508.2017702953121,0.0997982306379016,0.9002017693620984,4586,30,4616,0.9935008665511266,0.0064991334488734,9637603
95127,5382,46461,5322,12258,806400.0,101629.0,46968737,60283,51783,0.0,9.741262683201803,4.229319627998042,7.934743035944464,69944.84432228527,779.1373521556658,0.1027750420022015,0.8972249579977986,12202,56,12258,0.9954315549029206,0.0045684450970794,32287793
95128,2817,25081,2760,6608,1054000.0,96805.75,26271672,45593,27841,0.0,10.107971014492753,4.221852300242131,10.887783008757228,91808.15459195436,576.2216129669029,0.0991343701734851,0.9008656298265147,6600,8,6608,0.9987893462469734,0.0012106537530266,2213189
95129,3172,33032,3184,8592,1641700.0,153348.25,34415912,56310,36216,0.0,11.370603015075377,4.2136871508379885,10.705697652239266,137490.4376284008,611.1865032853844,0.0879169427877181,0.912083057212282,8586,6,8592,0.9993016759776536,0.0006983240223463,2206641
95130,1309,13303,1307,3462,1409500.0,137548.0,12389093,17580,14610,0.0,11.179801071155318,4.220681686886193,10.247331840521127,119128.8350330042,704.7265642775882,0.0894592744695414,0.9105407255304586,3461,1,3462,0.9997111496244944,0.0002888503755054,580000
95131,2555,20344,2442,5414,976300.0,134785.0,21435535,40030,22786,0.0,9.377149877149876,4.229589951976358,7.243387617316467,82657.1793520022,535.4867599300525,0.1071710699552356,0.8928289300447644,5412,2,5414,0.999630587366088,0.000369412633912,1841461
95132,3922,37644,3959,9828,1072200.0,126671.0,37111851,50014,41603,0.0,10.499115938368275,4.22934472934473,8.464447268909222,91256.1240558371,742.0292518094933,0.0951614066293296,0.9048385933706704,9818,10,9828,0.998982498982499,0.001017501017501,10141682
95133,1879,16827,1849,4386,869200.0,94510.75,17878348,31510,18676,0.0,10.11681990265008,4.264933880528956,9.196837396804067,75869.79987871337,567.3864804823866,0.0990040693938744,0.9009959306061256,4382,4,4386,0.9990880072959416,0.0009119927040583,5996615
95134,613,3130,599,967,379800.0,152559.0,10423679,52711,3729,0.0,6.248747913188648,3.870734229576008,2.4895286413780897,31821.55348072068,197.7514939955607,0.1606328774470367,0.8393671225529633,966,1,967,0.998965873836608,0.0010341261633919,267500
95135,2093,16635,2122,4362,1158400.0,157711.75,26704071,30704,18757,0.0,8.825636192271443,4.293443374598808,7.34504562913036,96787.20392104457,869.7261268890047,0.1131310977235165,0.8868689022764834,4361,1,4362,0.9997707473635948,0.0002292526364053,1565287
95136,3995,30404,3766,8169,897500.0,116985.75,36187257,61536,34170,0.0,9.13409453000531,4.210919329171257,7.671874565919353,76907.86731547001,588.0664489079563,0.1102136376938835,0.8897863623061165,8169,0,8169,1.0,0.0,$                                   -
95138,2364,17017,2323,4583,1129600.0,173084.75,26940785,24098,19340,0.0,8.343090830822213,4.228889373772638,6.5262826447737305,93653.07538417522,1117.9676736658644,0.1201137538779731,0.8798862461220269,4578,5,4583,0.9989090115644774,0.0010909884355225,17153960
95139,752,6872,717,1779,904600.0,145237.75,7234009,9444,7589,0.0,10.633193863319386,4.285553681843733,6.228408247855671,76105.52828481079,765.9899407030919,0.094478850968507,0.905521149031493,1778,1,1779,0.9994378864530636,0.0005621135469364,1038346
95148,4997,40599,4973,10763,998600.0,141455.25,44442786,48758,45572,0.0,9.168711039613916,4.236365325652699,7.059476406849516,84200.84337143142,911.4973132614136,0.109124023523216,0.890875976476784,10754,9,10763,0.9991638019139644,0.0008361980860354,6531517
95203,2140,12152,2008,3455,268100.0,45327.5,11197613,16426,14160,0.0,7.117529880478088,4.1366136034732275,5.914731675031714,25005.434808373695,681.7005357360282,0.1418079096045197,0.8581920903954803,3388,67,3455,0.9806078147612156,0.0193921852387843,13651298
95204,4867,32706,4740,8877,286300.0,54886.5,29648078,41631,37446,0.0,7.926793248945148,4.232623634110623,5.216218924507848,26234.71131558453,712.1634839422545,0.1265822784810126,0.8734177215189873,8843,34,8877,0.9961698772107694,0.0038301227892305,8078079
95205,4652,26627,4517,7657,225400.0,39942.0,20042273,31482,31144,0.0,6.924728802302413,4.08502024291498,5.6431826147914474,21273.817122004733,636.6264214471762,0.1450359619830465,0.8549640380169535,7537,120,7657,0.9843280658221236,0.0156719341778764,22032364
95206,8319,51237,7719,14611,291800.0,53387.25,43504133,60905,58956,0.0,7.715507190050524,4.076107042639108,5.465724494144201,26806.727420339274,714.2949347344224,0.1309281498066354,0.8690718501933645,14516,95,14611,0.9934980494148244,0.0065019505851755,23449985
95207,4770,33365,4729,9103,318500.0,52467.0,35107625,54063,38094,0.0,8.064072742651723,4.189278259914314,6.070482398459984,29306.382754430797,649.3835895159351,0.1241402845592481,0.8758597154407518,9092,11,9103,0.998791607162474,0.001208392837526,6182135
95209,6061,42404,5692,11736,367400.0,83480.0,44149523,51448,48096,0.0,8.514581869290232,4.129601226993865,4.401054144705319,32420.42464669148,858.1387614678899,0.1183466400532268,0.8816533599467731,11728,8,11736,0.9993183367416496,0.0006816632583503,3995549
95210,4258,29264,4160,8257,259000.0,47949.0,24784301,38504,33424,0.0,8.058173076923078,4.059828024706309,5.40157250411896,24030.67042808977,643.6812019530438,0.1244614648157012,0.8755385351842987,8252,5,8257,0.9993944531912315,0.0006055468087683,1413007
95212,3777,25634,3570,7162,401500.0,95157.25,28152983,29970,29204,0.0,8.238375350140055,4.106534487573303,4.219331685184261,35024.86090923606,939.372138805472,0.1222435282837967,0.8777564717162033,7159,3,7162,0.9995811225914548,0.000418877408545,1751578
95215,2639,17582,2492,4874,303500.0,48228.0,15380321,20717,20074,0.0,8.114365971107544,4.148748461222815,6.2930247988720245,28144.34187492998,742.4009750446493,0.1241406794859021,0.8758593205140979,4839,35,4874,0.9928190398030364,0.0071809601969634,13264681
95220,882,6216,837,1731,642500.0,87140.5,8036724,7659,7053,0.0,8.480286738351255,4.10051993067591,7.373150257343027,56482.14086384073,1049.3176654915785,0.118672905146746,0.8813270948532539,1731,0,1731,1.0,0.0,1881830
95222,1194,6776,1104,2029,399200.0,54367.75,10882041,8921,7880,0.0,7.219202898550725,3.9280433711187777,7.342588207163254,36612.00829870398,1219.823001905616,0.1401015228426396,0.8598984771573605,1761,268,2029,0.8679152291769344,0.1320847708230655,189735095
95227,103,696,107,148,877000.0,97425.75,1030357,891,803,0.0,7.467289719626168,5.398648648648648,9.001726956169184,76348.19976700659,1156.405162738496,0.1332503113325031,0.8667496886674969,146,2,148,0.9864864864864864,0.0135135135135135,$                                   -
95228,1616,8538,1527,2577,350500.0,83759.0,13313553,10878,10065,0.0,6.649639816633923,3.9402405898331394,4.184624935827792,30920.016744262884,1223.8971318257034,0.1517138599105812,0.8482861400894188,2270,307,2577,0.8808692277842453,0.1191307722157547,250903078
95231,318,2000,298,554,341300.0,53762.25,1902925,2460,2298,0.0,7.778523489932886,4.184115523465704,6.3483206153016285,31333.984503108055,773.5467479674796,0.1296779808529155,0.8703220191470844,553,1,554,0.9981949458483754,0.0018050541516245,404088
95236,405,3321,397,892,501400.0,75759.5,4209597,4165,3718,0.0,9.385390428211586,4.177130044843049,6.61831189487787,44627.12578837543,1010.70756302521,0.1067778375470683,0.8932221624529317,892,0,892,1.0,0.0,$                                   -
95237,533,3557,494,974,372700.0,66386.0,3435581,4263,4051,0.0,8.279352226720647,4.19917864476386,5.614135510499201,33566.77426242487,805.9068730940652,0.1219451987163663,0.8780548012836337,974,0,974,1.0,0.0,$                                   -
95240,5089,37028,4795,10158,352400.0,53875.5,35252330,52094,41823,0.0,8.783524504692387,4.14619019492026,6.5410065799853365,32346.801453250264,676.7061465811802,0.1146498338234942,0.8853501661765057,10152,6,10158,0.9994093325457768,0.0005906674542232,3109931
95242,4494,29884,3826,8577,440100.0,74477.75,31104939,41415,33710,0.0,8.985363303711448,4.008161361781509,5.909147362802985,39230.69786329384,751.0549076421586,0.1134974784930287,0.8865025215069712,8576,1,8577,0.999883409117407,0.0001165908825929,2237856
95245,593,2350,517,780,383800.0,61851.0,4297829,3478,2867,0.0,5.692456479690522,3.773076923076923,6.205235161921392,34788.17787539459,1235.718516388729,0.180327868852459,0.819672131147541,586,194,780,0.7512820512820513,0.2487179487179487,165365036
95247,1304,6285,1355,2193,357500.0,54188.75,13273064,9882,7640,0.0,5.600738007380074,3.4605563155494754,6.597310327328089,32797.47728934002,1343.1556365108277,0.1773560209424083,0.8226439790575916,1385,808,2193,0.6315549475604195,0.3684450524395805,708493148
95249,671,4135,648,1209,332300.0,35319.25,5504459,5605,4783,0.0,7.416666666666667,3.9751861042183623,9.408467054085238,31731.68256042233,982.0622658340768,0.1354798243780054,0.8645201756219946,1033,176,1209,0.8544251447477254,0.1455748552522746,122937546
95252,3244,17933,2996,4966,360200.0,78721.75,24087614,21752,20929,0.0,7.068424566088117,4.2643979057591626,4.575609663149002,31950.54031616079,1107.3746781905113,0.1431506522050743,0.8568493477949257,4712,254,4966,0.9488521949254932,0.0511478050745066,220913453
95255,524,2134,490,791,231500.0,42924.0,4426140,3514,2624,0.0,5.424489795918367,3.3603034134007586,5.393253191687634,21702.06758904132,1259.5731360273194,0.1867378048780487,0.8132621951219512,435,356,791,0.549936788874842,0.450063211125158,204221468
95258,508,4775,534,1241,479900.0,98313.25,5160409,5653,5309,0.0,9.893258426966293,4.257050765511684,4.881335933864459,41745.26673610078,912.8620201662834,0.1005839141081182,0.8994160858918817,1240,1,1241,0.999194198227236,0.0008058017727639,148154
95301,4529,32264,4171,8912,288800.0,60282.25,27300825,39604,36435,0.0,8.821146008151523,4.128478456014363,4.790796627531321,26238.342138441516,689.3451419048581,0.1144778372444078,0.8855221627555921,8904,8,8912,0.9991023339317774,0.0008976660682226,4000790
95303,34,302,40,77,592600.0,94241.25,302370,413,342,0.0,8.4,4.363636363636363,6.288116933932859,51739.13125951933,732.1307506053269,0.1169590643274853,0.8830409356725146,76,1,77,0.987012987012987,0.0129870129870129,925488
95304,1736,11606,1614,3163,692400.0,95007.5,15342205,16152,13220,0.0,8.26641883519207,4.218147328485615,7.28784569639239,60409.82825887359,949.8641035165924,0.1220877458396369,0.8779122541603631,3160,3,3163,0.9990515333544104,0.0009484666455896,2309827
95306,193,1061,160,330,283300.0,46636.75,1825681,1360,1221,0.0,7.8375,3.8,6.074608543691403,26353.135029453173,1342.4125,0.131040131040131,0.868959868959869,275,55,330,0.8333333333333334,0.1666666666666666,45164362
95307,4919,34934,4691,9633,313000.0,59958.75,29497429,42614,39625,0.0,8.495629929652527,4.137132772760303,5.220255592386432,28450.893123470356,692.2004270896888,0.118384858044164,0.881615141955836,9625,8,9633,0.999169521436728,0.000830478563272,3394541
95310,446,2147,497,699,379500.0,38516.75,3782535,3498,2644,0.0,5.217303822937626,3.709585121602289,9.852856224889171,35941.41921232551,1081.3421955403087,0.1879727685325264,0.8120272314674736,442,257,699,0.6323319027181689,0.3676680972818312,171756086
95311,421,2282,505,792,252400.0,43727.0,4317750,3445,2787,1.5,5.352475247524753,3.412878787878788,5.77217737324765,23620.305927187885,1253.3381712626997,0.1811984212414782,0.8188015787585217,470,322,792,0.5934343434343434,0.4065656565656566,154453744
95315,1211,9708,1109,2641,273000.0,61161.75,7287907,11147,10817,0.0,9.845807033363393,4.134418780764862,4.463574047505181,24770.268747902683,653.7998564636225,0.1025238051215679,0.8974761948784321,2641,0,2641,1.0,0.0,$                                   -
95316,861,6077,752,1690,375000.0,78440.75,5356612,7301,6829,0.0,9.226063829787234,4.105325443786982,4.780678410137588,33273.88741366248,733.6819613751541,0.1101186118026065,0.8898813881973935,1690,0,1690,1.0,0.0,$                                   -
95319,169,1305,185,329,194700.0,34746.5,958518,1653,1490,0.0,7.967567567567568,4.480243161094225,5.603442073302347,18621.18293428301,579.8656987295826,0.1241610738255033,0.8758389261744967,329,0,329,1.0,0.0,$                                   -
95320,1455,11379,1395,3074,448000.0,66936.5,10909186,14013,12774,0.0,9.2,4.17501626545218,6.692910444973968,40318.58998233319,778.5046742310711,0.1092062000939408,0.8907937999060592,3069,5,3074,0.998373454782043,0.001626545217957,2818083
95321,2005,8531,2151,3142,330900.0,55372.5,18011787,13234,10682,0.0,4.898186889818689,3.353278166772756,5.975890559393201,30297.09734800319,1361.0236512014508,0.2013667852462085,0.7986332147537915,1600,1542,3142,0.5092297899427116,0.4907702100572883,1037898331
95322,1117,8686,1054,2401,354500.0,56480.75,6732301,10106,9740,0.0,9.300759013282732,4.082882132444815,6.276474728115331,32399.120160888047,666.1687116564417,0.1082135523613963,0.8917864476386037,2400,1,2401,0.9995835068721366,0.0004164931278633,633200
95323,96,737,83,205,451400.0,73498.5,706594,950,820,0.0,10.036144578313252,4.0634146341463415,6.141621937862677,40285.51389000509,743.7831578947369,0.1012195121951219,0.8987804878048781,203,2,205,0.9902439024390244,0.0097560975609756,849104
95324,822,6095,682,1672,313200.0,65259.0,4878940,7561,6777,0.0,10.142228739002933,4.136961722488039,4.799338022341746,28251.545291018712,645.2770797513556,0.1006344990408735,0.8993655009591265,1671,1,1672,0.999401913875598,0.0005980861244019,405000
95326,1217,8424,1075,2361,366500.0,79339.25,7681826,10483,9499,0.0,8.968372093023255,4.083439220669208,4.619403384831593,32486.84855840682,732.7888963083087,0.1131698073481419,0.8868301926518581,2359,2,2361,0.9991529013130028,0.000847098686997,688636
95327,1189,6094,1229,1877,271800.0,51053.5,8390194,8343,7323,0.0,5.925956061838893,3.880127863612147,5.323826965829963,25072.34501203378,1005.65671820688,0.1678273931448859,0.8321726068551141,1538,339,1877,0.8193926478423016,0.1806073521576984,206373826
95328,609,3612,552,1020,306000.0,51800.5,2682085,4215,4164,0.0,7.646739130434782,4.1382352941176475,5.9072788872694275,28189.371568145987,636.3190984578885,0.132564841498559,0.8674351585014409,1020,0,1020,1.0,0.0,$                                   -
95329,747,3714,835,1113,284400.0,57838.5,5292917,4782,4549,0.0,5.34251497005988,4.008086253369272,4.917139967322804,25936.10289081996,1106.8416980342952,0.1835568256759727,0.8164431743240272,936,177,1113,0.8409703504043127,0.1590296495956873,106202937
95330,5733,23960,4026,8381,431400.0,88723.75,22278743,29525,27986,0.0,7.375310481867859,3.5428946426440757,4.862283210527058,37864.41574436697,754.5721591871295,0.1438576431072679,0.8561423568927321,8379,2,8381,0.9997613649922444,0.0002386350077556,1032800
95333,231,1736,256,478,274600.0,51350.75,1464799,2155,1992,0.0,7.68359375,4.115062761506276,5.34753630667517,25317.074645664667,679.7211136890951,0.1285140562248996,0.8714859437751004,477,1,478,0.997907949790795,0.002092050209205,473000
95334,1814,11350,1407,3328,246500.0,58789.25,8769298,13354,12757,0.0,9.356076759061834,3.9555288461538463,4.192943437788371,22446.404395505622,656.679496779991,0.1102923884925923,0.8897076115074077,3323,5,3328,0.998497596153846,0.0015024038461538,2185052
95336,6603,47730,6245,13218,398100.0,68094.0,42318625,60038,53975,0.0,8.700240192153723,4.110531093962778,5.8463300731341965,35772.551113680594,704.8640027982278,0.1157017137563686,0.8842982862436313,13214,4,13218,0.9996973823573916,0.0003026176426085,1754134
95337,7584,37956,5667,11759,466500.0,85472.0,36790714,50891,43623,0.0,8.035997882477501,3.872778297474275,5.45792774241857,41079.807653018746,722.9316382071486,0.1299085344886871,0.8700914655113129,11750,9,11759,0.9992346287949656,0.0007653712050344,8503156
95338,1913,13783,2069,4119,320800.0,52783.75,22633921,18193,15852,1.5,7.586273562107298,3.8106336489439183,6.077628057877662,29501.67552718917,1244.1005331720992,0.1305198082260913,0.8694801917739087,2823,1296,4119,0.685360524399126,0.314639475600874,836100990
95340,5381,37494,5010,10462,300400.0,56883.5,32454794,48310,42504,0.0,8.557884231536926,4.098164786847639,5.280968998039853,27436.89547104833,671.8028151521424,0.117871259175607,0.882128740824393,10456,6,10462,0.9994264958898872,0.0005735041101127,4818874
95341,3555,18914,2507,5878,232400.0,42803.5,12086184,21864,21421,0.0,8.962504986039091,3.8225586934331406,5.429462543950845,21792.181599539286,552.7892425905599,0.117034685588908,0.8829653144110919,5871,7,5878,0.9988091187478736,0.0011908812521265,2449901
95348,4965,25855,3777,7952,273400.0,49649.25,21436044,36941,29632,0.0,8.15991527667461,3.875754527162978,5.506629002452202,25284.99125280733,580.2778484610595,0.1274635529157667,0.8725364470842333,7947,5,7952,0.9993712273641852,0.0006287726358148,846726
95350,6840,51713,6667,13895,309800.0,55708.0,43979153,69697,58380,0.0,8.782510874456277,4.2139618567830155,5.561140231205572,28349.50851893736,631.0049643456676,0.1142000685166152,0.8857999314833848,13890,5,13895,0.9996401583303348,0.0003598416696653,2411264
95351,5037,33949,4880,9401,241800.0,44323.5,24825096,40702,38829,0.0,7.988934426229508,4.1470056376981175,5.455345358556973,22599.67207661384,609.9232470148887,0.1256792603466481,0.8743207396533519,9394,7,9401,0.9992553983618764,0.0007446016381236,2956210
95354,3893,24365,3713,6788,280500.0,51686.0,20037052,32046,28078,0.0,7.61055750067331,4.162934590453742,5.427001509112719,25845.52594449913,625.2590650939275,0.1322387634446898,0.8677612365553102,6780,8,6788,0.9988214496169712,0.0011785503830288,1627347
95355,8289,60085,7634,16445,359200.0,68031.75,55359419,81493,67719,0.0,8.956510348441185,4.157737914259654,5.279887699493251,32279.719841969483,679.3150209220424,0.1127305482951608,0.8872694517048391,16437,8,16445,0.9995135299483126,0.0004864700516874,2980078
95356,4574,31162,4217,8601,389900.0,74520.75,34318292,43173,35379,0.0,8.47427080863173,4.154865713289152,5.232099784288269,34754.060770404605,794.9017209830218,0.1191950026852087,0.8808049973147912,8600,1,8601,0.9998837344494826,0.0001162655505173,1643931
95357,1594,11766,1488,3141,340300.0,77146.25,10596452,14056,13254,0.0,8.978494623655914,4.253422476918179,4.411102289482638,30239.593237928977,753.8739328400683,0.1122679945676776,0.8877320054323223,3135,6,3141,0.9980897803247374,0.0019102196752626,3620432
95358,3384,23862,3282,6517,319900.0,62095.25,19238051,28831,27144,0.0,8.30164533820841,4.180758017492711,5.151762815996393,28985.836129760333,667.2696403177135,0.1209106984969053,0.8790893015030946,6507,10,6517,0.9984655516341876,0.0015344483658124,3475629
95360,1678,11720,1507,3213,298300.0,64218.0,9483385,13603,13227,0.0,8.89051094890511,4.169934640522876,4.645115076769753,26946.60829441331,697.1539366316254,0.1139336206244802,0.8860663793755198,3211,2,3213,0.9993775287892936,0.0006224712107065,95978
95363,4157,24706,3718,7083,360300.0,73717.0,23903904,29797,28424,0.0,7.763044647660032,4.074968233799238,4.887610727511971,32146.713305629895,802.225190455415,0.1308049535603715,0.8691950464396285,7076,7,7083,0.9990117181985034,0.0009882818014965,3481618
95365,477,3194,392,858,183900.0,41152.75,2127079,3546,3586,0.0,9.364795918367347,4.278554778554779,4.468717157419613,17308.16030694422,599.8530738860688,0.109313998884551,0.8906860011154489,853,5,858,0.9941724941724942,0.0058275058275058,1168910
95366,2338,18327,2083,4913,522100.0,87171.0,18928763,23277,20410,0.0,9.920787325972157,4.20618766537757,5.989377201133404,45896.37130795593,813.195987455428,0.1020578147966683,0.8979421852033317,4912,1,4913,0.9997964583757378,0.0002035416242621,961387
95367,3389,24031,3265,6553,344800.0,71474.0,20459071,28408,27296,0.0,8.398162327718223,4.184343048985197,4.824131852142037,30848.819329627808,720.1869543790482,0.1196145955451348,0.8803854044548651,6553,0,6553,1.0,0.0,$                                   -
95368,1837,14495,1829,3895,349000.0,81592.0,12495249,16741,16324,0.0,8.92946965554948,4.193068035943518,4.277380135307383,30859.049179175938,746.3860581805149,0.1120436167605978,0.8879563832394021,3895,0,3895,1.0,0.0,$                                   -
95370,6966,29639,6552,9968,342700.0,60253.0,52623488,45320,36191,0.0,5.586843711843712,3.672251203852328,5.687683600816557,31136.690989101015,1161.1537511032657,0.181039484954823,0.818960515045177,6654,3314,9968,0.6675361155698234,0.3324638844301765,2286660131
95374,136,768,105,235,357300.0,49926.0,739722,1085,873,0.0,8.60952380952381,3.8468085106382977,7.156591755798582,33027.37887364428,681.7714285714286,0.120274914089347,0.8797250859106529,235,0,235,1.0,0.0,$                                   -
95376,6695,49118,6539,13378,454200.0,83514.0,47117401,63595,55657,0.0,8.535402966814498,4.171998804006578,5.438609095480997,40078.464274505866,740.8978850538564,0.1174874678836444,0.8825125321163555,13375,3,13378,0.9997757512333684,0.0002242487666317,812729
95379,808,4223,753,1350,319000.0,60347.5,6476760,6104,4976,0.0,6.681274900398407,3.7266666666666666,5.286051617714072,28979.254013794976,1061.0681520314547,0.1513263665594855,0.8486736334405145,922,428,1350,0.682962962962963,0.317037037037037,285919161
95382,5024,35581,4727,9687,374600.0,74457.5,33397614,49167,40308,0.0,8.590014808546647,4.1917002167853825,5.031057986099452,33392.80993987871,679.2688998718653,0.1172720055572094,0.8827279944427905,9682,5,9687,0.9994838443274492,0.0005161556725508,3067446
95383,1923,8231,2066,3302,364200.0,74946.5,17433428,13889,10297,0.0,4.914811229428848,3.075105996365839,4.8594664193791575,32446.793437119064,1255.1967744258045,0.2006409633873944,0.7993590366126057,1546,1756,3302,0.4682010902483343,0.5317989097516657,1224246640
95386,1258,8567,1185,2383,323200.0,61927.75,6979632,10297,9752,0.0,8.291139240506329,4.122954259336971,5.2189850269063545,29292.015089623743,677.8316014373119,0.1215135356849877,0.8784864643150123,2381,2,2383,0.9991607217792698,0.0008392782207301,777026
95388,1403,9281,1237,3177,231700.0,48069.75,6560275,11039,10518,0.0,8.637025060630558,3.36292099464904,4.820079155810046,21492.69232295585,594.2816378295136,0.1176079102490967,0.8823920897509032,3175,2,3177,0.9993704752911552,0.0006295247088448,776669
95401,3858,33914,3552,8998,541300.0,76125.25,33828783,50741,37466,0.0,10.63400900900901,4.197821738164037,7.110649882923209,48157.78334322439,666.6952365936817,0.0948059574013772,0.9051940425986228,8993,5,8998,0.9994443209602134,0.0005556790397866,4581255
95403,5437,38663,5124,10839,588800.0,78611.5,43952025,62584,43787,0.0,8.60655737704918,4.068641018544146,7.489998282694008,52234.36173619471,702.2885242234437,0.1170210336401215,0.8829789663598785,10786,53,10839,0.9951102500230647,0.0048897499769351,100532757
95404,5296,43226,5512,11568,710100.0,83420.75,60443697,60396,48738,0.0,8.802975326560233,4.194502074688796,8.51227062811111,62665.17693477455,1000.7897377309756,0.1130945053141286,0.8869054946858714,11277,291,11568,0.9748443983402488,0.025155601659751,530106073
95405,2572,24856,2604,6556,648800.0,92154.75,29029599,36808,27460,0.0,10.533026113671276,4.183648566198902,7.040331616113114,56756.82421745748,788.676347533145,0.09482884195193,0.90517115804807,6550,6,6556,0.99908480780964,0.0009151921903599,12197130
95407,3539,28563,3199,7979,506600.0,67053.5,26804996,40955,31762,0.0,10.035010940919037,4.0233111918786815,7.555161177268897,45585.24089406854,654.4987425222805,0.1007178389270197,0.8992821610729803,7955,24,7979,0.9969921042737184,0.0030078957262814,11487045
95409,4327,33084,4048,8922,665600.0,78341.75,45831791,52810,37132,0.0,9.241847826086955,4.193118134947321,8.496108396863741,59065.550622920186,867.8619768983148,0.1090164817408165,0.8909835182591834,8876,46,8922,0.9948442053351266,0.0051557946648733,97095805
95421,343,2850,339,838,571400.0,58782.0,4017419,3524,3189,0.0,9.418879056047198,3.810262529832936,9.720662787928278,52032.53352299974,1140.016742338252,0.1063029162746942,0.8936970837253058,738,100,838,0.8806682577565632,0.1193317422434367,87756029
95422,2777,17640,2951,4824,156400.0,33952.5,16654040,22049,20591,0.0,6.91867163673331,4.2323797678275294,4.606435461306237,14991.299820268125,755.3195156242914,0.1433150405516973,0.8566849594483027,4637,187,4824,0.961235489220564,0.0387645107794361,78134837
95423,1144,7120,1131,1969,223600.0,45886.0,7625341,8727,8251,0.0,7.306808134394341,4.197054342305739,4.87294599660027,20831.168585361367,873.7642947175433,0.1370742940249666,0.8629257059750334,1884,85,1969,0.956830878618588,0.0431691213814118,51510931
95425,1532,12559,1460,3478,556700.0,79333.0,15478146,16544,14019,0.0,9.6513698630137,4.051466359976998,7.017256375026786,49346.67089786669,935.5745889748548,0.1041443754904058,0.8958556245095941,3377,101,3478,0.9709603220241518,0.0290396779758481,135044357
95426,426,2592,398,694,260400.0,82928.0,4313477,3519,2990,0.0,7.582914572864322,4.348703170028818,3.1400733166120007,22991.89942319375,1225.7678317703894,0.1331103678929766,0.8668896321070234,521,173,694,0.7507204610951008,0.2492795389048991,145090506
95428,179,1225,203,354,301300.0,40495.25,1906878,1669,1428,0.0,6.916256157635468,3.9661016949152543,7.440378809860416,28400.57546481321,1142.5272618334332,0.142156862745098,0.8578431372549019,318,36,354,0.8983050847457628,0.1016949152542373,23146434
95436,1031,8511,1061,2358,578800.0,70154.25,9857341,10710,9572,0.0,8.99340245051838,4.046649703138253,8.2503911024635,51870.99583463824,920.3866479925304,0.1108441287087338,0.8891558712912662,2240,118,2358,0.9499575911789652,0.0500424088210347,101642830
95437,2277,18508,2116,5075,446400.0,49155.25,19279294,22678,20624,0.0,9.822778827977316,4.095566502463054,9.081430772908286,41322.85364437464,850.132022224182,0.1025989138867339,0.8974010861132661,4993,82,5075,0.9838423645320196,0.0161576354679802,72176508
95441,220,1704,188,555,952800.0,106010.0,3826925,2555,1892,0.0,10.23404255319149,3.466666666666667,8.987831336666352,82341.7360003531,1497.8180039138942,0.0993657505285412,0.9006342494714588,486,69,555,0.8756756756756757,0.1243243243243243,112652280
95442,566,4471,560,1340,1177600.0,136337.5,9410840,5894,5031,0.0,8.994642857142857,3.758955223880597,8.637388832859632,99603.40734490436,1596.6813708856464,0.1113098787517392,0.8886901212482607,1245,95,1340,0.9291044776119404,0.0708955223880597,158543877
95445,585,4029,556,1208,585200.0,60917.75,6848111,5046,4585,0.0,8.298561151079136,3.8195364238410594,9.606395508698204,53116.5593290484,1357.136543797067,0.1212649945474372,0.8787350054525627,1074,134,1208,0.8890728476821192,0.1109271523178807,126174679
95446,1454,9857,1471,2851,506700.0,70296.25,11540741,12726,11328,0.0,7.689326988443236,3.9673798667134337,7.208065864110817,45401.2985556658,906.8631934622034,0.1298552259887005,0.8701447740112994,2625,226,2851,0.9207295685724308,0.0792704314275692,193759169
95448,2340,19841,2204,5688,919400.0,95259.5,34052630,27831,22045,0.0,10.063974591651542,3.899613220815752,9.651530818448554,80196.36490402598,1223.5503575150012,0.0999773191199818,0.9000226808800181,5375,313,5688,0.944971870604782,0.055028129395218,439765451
95449,176,1065,136,333,465000.0,56081.0,1524749,1479,1201,0.0,9.125,3.7267267267267266,8.291578252884221,42525.74636611708,1030.9323867478026,0.1132389675270607,0.8867610324729392,310,23,333,0.9309309309309308,0.069069069069069,19541440
95451,2512,15656,2537,4563,285000.0,54050.75,24775334,20542,18193,0.0,7.16121403232164,3.981591058514136,5.272822301263164,26152.358485834615,1206.081881024243,0.1394492387181883,0.8605507612818117,3817,746,4563,0.836511067280298,0.1634889327197019,519230590
95452,252,2419,269,664,915600.0,97684.0,4976271,2917,2688,0.0,9.929368029739775,4.022590361445783,9.37308054543221,79690.20002701563,1705.9550908467604,0.1000744047619047,0.8999255952380952,644,20,664,0.9698795180722892,0.0301204819277108,43428282
95453,2009,14144,1956,3887,342500.0,54731.0,17344702,18034,16100,0.0,8.258179959100204,4.155647028556728,6.257879446748643,31392.683310302415,961.7778640346012,0.1214906832298136,0.8785093167701863,3809,78,3887,0.979933110367893,0.020066889632107,61185958
95454,277,1933,291,603,371700.0,36082.5,3506221,2624,2224,0.0,7.594501718213058,3.665008291873963,10.3013926418624,35421.71431295059,1336.2122713414635,0.1308453237410071,0.8691546762589928,477,126,603,0.7910447761194029,0.208955223880597,85202302
95456,190,1485,184,418,410000.0,33334.25,2621377,1806,1669,0.0,9.103260869565217,4.007177033492823,12.29966175930162,39368.79085853635,1451.4822812846069,0.1102456560814859,0.889754343918514,380,38,418,0.9090909090909092,0.0909090909090909,38440939
95457,587,4012,587,1218,332800.0,44852.5,6341484,5229,4599,0.0,7.834752981260648,3.775862068965518,7.419876261077977,31070.47126206278,1212.75272518646,0.1276364427049358,0.8723635572950641,1009,209,1218,0.8284072249589491,0.1715927750410509,132643844
95458,715,4598,732,1249,234500.0,45352.75,4861484,5627,5330,0.0,7.258196721311475,4.2538030424339475,5.170579512818958,21870.458425536603,863.9566376399503,0.1373358348968105,0.8626641651031894,1180,69,1249,0.944755804643715,0.055244195356285,32986727
95460,539,4324,486,1233,566400.0,65203.75,7327624,5375,4810,0.0,10.006172839506172,3.9440389294403895,8.68661695071219,51094.82082475609,1363.2788837209305,0.101039501039501,0.898960498960499,1191,42,1233,0.9659367396593674,0.0340632603406326,38914143
95461,547,3847,505,1166,315900.0,52918.5,5911799,5368,4352,0.0,8.700990099009902,3.7684391080617496,5.969556960231299,29044.247663532293,1101.3038375558867,0.1160386029411764,0.8839613970588235,976,190,1166,0.8370497427101201,0.1629502572898799,143911922
95464,462,3119,507,836,127500.0,50892.0,3255676,3822,3626,0.0,7.063116370808679,4.283492822966507,2.5053053525112,11764.748198252382,851.8252223966509,0.1398234969663541,0.8601765030336459,793,43,836,0.9485645933014354,0.0514354066985645,23121473
95465,264,2267,228,638,957300.0,67436.0,4009932,2894,2495,0.0,11.100877192982455,3.9670846394984327,14.195681831662611,86096.38082073753,1385.6019350380095,0.0913827655310621,0.9086172344689378,595,43,638,0.932601880877743,0.067398119122257,57837413
95467,1480,8554,1353,2370,338300.0,69720.0,11417823,10658,9907,0.0,7.416112342941611,4.233755274261603,4.852266207687895,30334.706227120136,1071.2913304559954,0.1365701019481175,0.8634298980518825,2247,123,2370,0.9481012658227848,0.0518987341772151,132297919
95470,726,6048,714,1688,495100.0,65516.75,7916566,7373,6762,0.0,9.487394957983192,4.01303317535545,7.556846150030336,44643.57724499284,1073.7238573172383,0.1055900621118012,0.8944099378881988,1607,81,1688,0.9520142180094788,0.0479857819905213,65573872
95472,3641,35886,3436,9653,890700.0,94522.5,47270197,47834,39322,0.0,11.503783469150177,4.094789184709417,9.4231532174879,77745.62524620217,988.213341974328,0.0873811098113015,0.9126188901886984,9555,98,9653,0.9898477157360406,0.0101522842639593,154385573
95476,5088,42661,4952,11567,767900.0,85397.5,62760880,60310,47613,0.0,9.642366720516964,4.1280366560041495,8.992066512485728,67626.16678045053,1040.638036809816,0.1040052086615,0.8959947913385,11468,99,11567,0.9914411688423964,0.0085588311576035,215942287
95482,3446,28386,3292,7582,402700.0,54644.5,29707415,36509,31678,0.0,9.669501822600242,4.198364547612767,7.369451637401752,36915.81485655522,813.701142184119,0.1039207020645242,0.8960792979354757,7361,221,7582,0.9708520179372198,0.0291479820627802,201468935
95485,343,2496,343,719,299100.0,48608.75,3515860,3249,2839,0.0,8.276967930029155,3.948539638386648,6.15321315606758,27716.107059019017,1082.1360418590336,0.1208171891511095,0.8791828108488905,660,59,719,0.917941585535466,0.082058414464534,34185145
95490,2006,13903,1919,4064,337600.0,49366.5,18217101,18063,15822,0.0,8.290255341323606,3.9146161417322833,6.838645640262121,31238.93273513718,1008.5313070918452,0.1212868158260649,0.8787131841739351,3463,601,4064,0.8521161417322834,0.1478838582677165,379970732
95492,3454,32230,3444,8327,652800.0,112699.0,36893753,42057,35674,0.0,10.361207897793264,4.285336856010568,5.792420518371946,56118.749758487575,877.2321611146778,0.0965408981330941,0.903459101866906,8316,11,8327,0.998678996036988,0.0013210039630118,18791896
95497,766,4688,647,1401,943200.0,80215.0,9884397,6361,5335,0.0,8.42967542503864,3.892933618843683,11.758399301876208,83524.71603378428,1553.906146832259,0.1212746016869728,0.8787253983130272,1332,69,1401,0.9507494646680942,0.0492505353319057,100133220
95501,2643,24097,2642,6253,299400.0,44614.5,18968405,31502,26739,1.5714285714285714,10.12112036336109,4.27634735327043,6.710822714588306,27966.112103469502,602.1333566122786,0.0988069860503384,0.9011930139496616,6244,9,6253,0.9985606908683832,0.0014393091316168,3446578
95503,3407,30708,3283,8111,337600.0,56590.75,25710096,36931,33991,1.5714285714285714,10.391410295461467,4.2060165207742575,5.965639260833264,30849.07842051657,696.165714440443,0.0965843899855844,0.9034156100144156,8069,42,8111,0.9948218468746148,0.0051781531253852,27498922
95519,2482,21992,2300,5842,352700.0,56686.0,18497374,27330,24292,1.5714285714285714,10.640869565217391,4.18931872646354,6.221994848816286,32223.92830235865,676.815733626052,0.0946813765848839,0.905318623415116,5818,24,5842,0.9958918178705922,0.0041081821294077,16803789
95521,1951,18371,1866,4903,379000.0,40370.75,15490631,24954,20237,1.5714285714285714,10.890675241157556,4.144809300428309,9.38798511298403,35734.958947611245,620.7674521118859,0.0922073429856204,0.9077926570143796,4853,50,4903,0.9898021619416684,0.0101978380583316,26803964
95524,217,2443,218,629,484900.0,66321.75,2818259,2820,2661,1.5714285714285714,12.20183486238532,4.228934817170111,7.31132697795218,43675.740299631274,999.3826241134752,0.0819240886884629,0.918075911311537,620,9,629,0.985691573926868,0.0143084260731319,5649963
95525,192,1939,202,542,388200.0,49507.0,1892874,2415,2141,0.0,10.549504950495049,3.9317343173431736,7.841315369543701,35911.62735958811,783.7987577639751,0.0943484353106025,0.9056515646893974,518,24,542,0.955719557195572,0.044280442804428,16183840
95526,56,602,72,182,262100.0,33267.75,985203,871,674,1.5714285714285714,9.13888888888889,3.6153846153846154,7.878500950620346,25172.046427706333,1131.1171067738233,0.1068249258160237,0.8931750741839762,137,45,182,0.7527472527472527,0.2472527472527472,23334755
95528,157,1292,162,361,383900.0,64520.5,1342912,1570,1454,1.5714285714285714,8.944444444444445,4.013850415512465,5.950046884323587,34664.47605654299,855.3579617834395,0.1114167812929848,0.8885832187070152,339,22,361,0.9390581717451524,0.0609418282548476,9940029
95531,3002,22045,2924,5932,236100.0,47921.5,19999451,26958,24969,0.0,8.566005471956224,4.222353337828726,4.926807382907463,21907.1170011122,741.8744343052156,0.1171052104609716,0.8828947895390284,5884,48,5932,0.9919082939986514,0.0080917060013486,24485300
95536,288,2809,247,768,443500.0,56532.75,2868520,3721,3056,1.5714285714285714,12.538461538461538,4.032552083333333,7.845010193206592,40529.76415347673,770.9002956194571,0.0808246073298429,0.919175392670157,752,16,768,0.9791666666666666,0.0208333333333333,9709754
95540,1880,15775,1773,4122,313500.0,48483.25,12904855,19462,17548,1.5714285714285714,9.957698815566836,4.28311499272198,6.466150680905261,29057.444200225484,663.0795909978419,0.1010371552313654,0.8989628447686346,4099,23,4122,0.9944201843765162,0.0055798156234837,14472248
95542,244,1958,252,679,386700.0,30521.0,4693725,2954,2210,1.5714285714285714,8.738095238095237,3.2430044182621502,12.669964942170964,37448.540032565565,1588.9387271496275,0.1140271493212669,0.885972850678733,482,197,679,0.7098674521354934,0.2901325478645066,132236866
95547,167,1516,161,391,470800.0,57399.5,1459225,1714,1677,1.5714285714285714,10.453416149068325,4.304347826086956,8.202162039739022,42964.86449890731,851.3564760793465,0.096004770423375,0.9039952295766248,390,1,391,0.9974424552429668,0.0025575447570332,1825812
95549,100,1067,115,302,536500.0,73479.25,1693438,1241,1182,1.5714285714285714,10.147826086956522,3.8642384105960264,7.301381002119646,47881.44323004105,1364.5753424657537,0.0972927241962774,0.9027072758037225,277,25,302,0.9172185430463576,0.0827814569536423,17435146
95551,203,1590,193,408,391100.0,60276.0,1369311,1943,1783,1.5714285714285714,9.290155440414509,4.394607843137255,6.488486296370032,35532.93725022403,704.7406073082861,0.108244531688166,0.8917554683118339,404,4,408,0.9901960784313726,0.0098039215686274,2536306
95552,35,460,67,147,246400.0,22312.25,783032,674,527,0.0,7.388059701492537,3.36734693877551,11.043260988918645,24608.277140243135,1161.768545994065,0.127134724857685,0.872865275142315,104,43,147,0.7074829931972789,0.2925170068027211,20250676
95562,543,3914,538,1062,239000.0,38628.5,3007253,4694,4452,0.0,8.284386617100372,4.196798493408663,6.187141618235241,22628.83508903091,640.6589262888795,0.1208445642407906,0.8791554357592093,1057,5,1062,0.995291902071563,0.0047080979284369,4047580
95567,316,2280,291,652,254000.0,70001.5,2496322,2777,2571,0.0,8.920962199312715,3.98159509202454,3.628493675135533,22767.462208938672,898.9276197335254,0.1131855309218203,0.8868144690781797,649,3,652,0.995398773006135,0.004601226993865,1541226
95570,460,3836,475,1042,446600.0,53955.25,4485351,4617,4311,1.5714285714285714,9.044210526315789,4.122840690978887,8.277229741313404,40987.855864630175,971.4860298895388,0.1101832521456738,0.8898167478543262,1021,21,1042,0.9798464491362764,0.0201535508637236,13055757
95602,4821,20323,4644,6180,511000.0,81974.0,40034479,30961,24967,1.8,5.414298018949181,4.068608414239482,6.2336838509771395,45164.65361120568,1293.061561319079,0.1860055272960307,0.8139944727039692,4561,1619,6180,0.7380258899676375,0.2619741100323625,1624727916
95603,5545,31924,5298,9077,474900.0,71167.75,44710464,44994,37222,1.8,7.072291430728577,4.127905695714443,6.672966336578015,42505.03102155078,993.698359781304,0.1423351781204664,0.8576648218795336,8389,688,9077,0.9242040321692188,0.075795967830781,602341515
95605,1526,10666,1513,2913,313500.0,54930.5,8728787,15044,12179,0.0,8.058162590879048,4.185375901132852,5.707211840416527,28725.037088102727,580.2171629885669,0.1242302323671894,0.8757697676328106,2913,0,2913,1.0,0.0,253000
95608,7916,60670,7736,16280,448700.0,66905.5,70938415,85706,68406,0.0,8.865822130299897,4.2128992628992625,6.706474056691901,40383.27133724044,827.694852169043,0.1130894950735315,0.8869105049264684,16274,6,16280,0.9996314496314496,0.0003685503685503,6189622
95610,5477,39042,5304,10806,375700.0,63770.25,40003289,64891,44346,0.0,8.393476621417799,4.1198408291689805,5.891461927779804,33959.91789370578,616.4689864542079,0.1196049249086727,0.8803950750913273,10802,4,10806,0.999629835276698,0.0003701647233018,1999011
95614,1324,5204,1231,1629,430400.0,104035.0,9792511,7096,6435,1.6666666666666667,5.303005686433794,4.0073664825046045,4.137069255539001,37256.06111415421,1380.004368658399,0.1912975912975913,0.8087024087024087,1209,420,1629,0.7421731123388582,0.2578268876611418,368519347
95615,60,458,68,118,602300.0,59034.5,593015,592,526,0.0,7.617647058823529,4.389830508474576,10.202508702538346,54824.934201947675,1001.714527027027,0.1292775665399239,0.870722433460076,118,0,118,1.0,0.0,$                                   -
95616,2937,33096,2857,8497,730800.0,58938.75,35542963,66240,35953,0.0,12.612180609030451,4.2406731787689775,12.399312845962973,66531.60030736554,536.578547705314,0.0794648568965037,0.9205351431034964,8492,5,8497,0.9994115570201249,0.0005884429798752,1426726
95618,2510,23635,2280,6226,697900.0,98098.25,27079924,39803,25915,0.0,11.467105263157896,4.19932540957276,7.114296126587376,60720.08959254734,680.3488179282969,0.0879799344009261,0.912020065599074,6226,0,6226,1.0,0.0,530550
95619,918,5473,910,1525,277300.0,63637.0,6796540,7297,6383,0.0,7.023076923076923,4.1908196721311475,4.357527853292896,25070.178551266155,931.4156502672332,0.1425661914460285,0.8574338085539714,1376,149,1525,0.9022950819672132,0.0977049180327868,95554886
95620,2905,19965,2385,5799,458600.0,81501.5,20225971,25436,22350,0.0,9.58909853249476,3.943783410932919,5.626890302632467,40554.0080601577,795.1710567699324,0.1067114093959731,0.8932885906040269,5798,1,5799,0.9998275564752545,0.0001724435247456,$                                   -
95621,6536,43760,6329,11804,327900.0,64358.25,40091920,64283,50089,0.0,7.946911044398799,4.2609284988139615,5.094917900968407,29614.656126767604,623.6784219778168,0.1263550879434606,0.8736449120565394,11801,3,11804,0.9997458488647916,0.0002541511352084,2586174
95623,1100,5212,1119,1544,443500.0,71982.75,9389648,7159,6331,0.0,5.640750670241287,4.0880829015544045,6.161198342658484,39654.21954753434,1311.5865344321833,0.1767493287000474,0.8232506712999527,1259,285,1544,0.8154145077720207,0.1845854922279792,227474179
95624,10150,67988,9332,18859,473300.0,98028.5,72048643,81278,77320,0.0,8.373124732104586,4.143273768492497,4.828187720917897,41181.540306598436,886.4470459410911,0.1206932229694775,0.8793067770305225,18857,2,18859,0.9998939498382736,0.0001060501617264,1392583
95627,408,3416,403,908,357900.0,78085.25,3048566,4030,3819,0.0,9.488833746898264,4.211453744493392,4.5834520604083355,31769.40272310725,756.4679900744417,0.1055250065462162,0.8944749934537837,908,0,908,1.0,0.0,$                                   -
95628,6949,50600,6693,13600,489000.0,89449.25,60052294,68439,57293,0.0,8.598386373823397,4.231544117647059,5.466787032870594,42889.36925887686,877.4572100702816,0.1168205539943797,0.8831794460056203,13592,8,13600,0.9994117647058824,0.0005882352941176,2346385
95630,12388,78486,10847,26994,598100.0,117684.0,90970427,116325,89333,0.0,8.377800313450724,3.366451804104616,5.082254172189932,51225.79470368123,782.0367676767677,0.1214220948585629,0.8785779051414371,26988,6,26994,0.9997777283840854,0.0002222716159146,5425121
95631,2041,6651,1917,2301,409400.0,83294.5,15478939,11368,8568,1.8,4.534167970787689,3.7774880486744897,4.915090432141378,36133.717633666834,1361.6237684729065,0.2237394957983193,0.7762605042016807,833,1468,2301,0.3620165145588874,0.6379834854411126,1180093107
95633,845,3430,728,1177,341700.0,73466.75,7799145,5428,4158,0.0,5.872252747252747,3.6321155480033984,4.651083653489504,30496.43537477421,1436.8358511422257,0.1750841750841751,0.8249158249158249,631,546,1177,0.536108751062022,0.4638912489379779,386827843
95634,789,3502,723,1166,323700.0,59530.5,7420252,5317,4225,1.6666666666666667,5.934993084370678,3.6801029159519727,5.437548819512687,29442.67910364726,1395.5711867594507,0.1711242603550296,0.8288757396449704,672,494,1166,0.5763293310463122,0.4236706689536878,353408376
95640,2165,10591,1752,3223,345100.0,70289.5,11395824,13038,12343,0.0,7.280821917808219,3.9578032888613097,4.909694904644364,30921.892526186897,874.0469397146802,0.1419428015879446,0.8580571984120554,3171,52,3223,0.9838659633881476,0.0161340366118523,41282018
95642,1696,8941,1507,2602,348900.0,62389.75,13023171,12285,10448,0.0,7.0583941605839415,4.088009223674097,5.592264755027869,31599.951238240883,1060.0871794871796,0.1442381316998468,0.8557618683001531,2337,265,2602,0.8981552651806303,0.1018447348193697,220942622
95648,11197,71062,10087,20375,514000.0,87814.5,74595396,86877,81149,1.8,8.154951918310697,4.037251533742332,5.853247470520245,45155.12752994016,858.6322732138541,0.1243022095158289,0.8756977904841711,20328,47,20375,0.9976932515337424,0.0023067484662576,43679284
95650,2626,16094,2456,4498,682700.0,101905.5,25380730,19764,18550,1.8,7.62214983713355,4.161849710982659,6.699344000078504,59201.50621912046,1284.1899413074275,0.1323989218328841,0.867601078167116,4346,152,4498,0.9662072032014228,0.0337927967985771,201905584
95658,1478,8127,1336,2515,702600.0,98854.5,13516772,10366,9463,1.8,7.18937125748503,3.8190854870775346,7.107415443909989,61088.19223748414,1303.952537140652,0.1411814435168551,0.8588185564831449,2386,129,2515,0.9487077534791252,0.0512922465208747,134843452
95659,72,504,57,136,435700.0,58222.25,648257,690,561,0.0,10.105263157894736,4.235294117647059,7.483393376243618,39710.08859876232,939.5028985507248,0.1016042780748663,0.8983957219251337,134,2,136,0.9852941176470588,0.0147058823529411,1486600
95660,4469,27288,4319,7677,256000.0,49371.5,21068813,34046,31607,0.0,7.352859458207918,4.136641917415657,5.185177683481361,23688.06823280408,618.8337249603478,0.1366469452969279,0.8633530547030721,7673,4,7677,0.999478963136642,0.000521036863358,2332824
95661,4533,34073,4375,9090,550300.0,88908.0,37190501,50535,38448,1.8,8.824228571428572,4.247084708470847,6.1895442479866825,48291.59633908166,735.9355100425448,0.1137900540990428,0.8862099459009571,9088,2,9090,0.9997799779977998,0.0002200220022002,1195453
95662,5149,38502,5054,10229,408300.0,80260.25,38121304,49819,43556,0.0,8.636921250494657,4.267377065206765,5.08720070022209,36155.045078643736,765.1960898452397,0.1160345302598953,0.8839654697401047,10227,2,10229,0.999804477466028,0.000195522533972,979640
95663,602,3317,607,926,713900.0,110783.75,5256167,4326,3924,1.8,6.456342668863262,4.232181425485961,6.444085888047661,61461.84991895179,1215.017799352751,0.1546890927624872,0.8453109072375128,909,17,926,0.9816414686825052,0.0183585313174946,16170800
95664,327,1388,313,476,420700.0,76749.0,4365449,2093,1701,0.0,5.479233226837061,3.602941176470588,5.481504645011661,37401.22180392719,2085.737697085523,0.1840094062316284,0.8159905937683716,256,220,476,0.5378151260504201,0.4621848739495798,180665271
95665,1422,5241,1237,1868,315400.0,73306.5,11100128,8402,6478,0.0,5.386418755052547,3.5669164882226982,4.3024834087018204,28154.66967769475,1321.1292549393002,0.1909539981475764,0.8090460018524236,1005,863,1868,0.5380085653104925,0.4619914346895075,596860204
95666,2317,9178,2231,3243,288400.0,65394.0,19373352,14642,11409,0.0,5.152398027790229,3.5445575084798024,4.410190537358168,26009.665193114277,1323.1356372080318,0.1955473748794811,0.8044526251205188,1548,1695,3243,0.4773358001850138,0.5226641998149861,1137511407
95667,9043,39475,8426,12484,434200.0,73423.25,81739757,59813,47901,1.6666666666666667,5.75812959886067,3.8864146107016984,5.913658139621986,38754.03052849972,1366.5884841088057,0.1759044696352894,0.8240955303647105,8168,4316,12484,0.6542774751682153,0.3457225248317846,3413841672
95669,573,2668,439,834,459000.0,78659.75,4066764,3391,3107,0.0,7.382687927107061,3.886091127098321,5.835258820425948,40717.165477223025,1199.2816278383957,0.1412938525909237,0.8587061474090762,779,55,834,0.934052757793765,0.065947242206235,93327722
95670,7552,51252,7233,14045,375500.0,70633.5,49975841,75252,58485,0.0,8.129959905986452,4.1868280526877895,5.316174336540027,33631.10274327646,664.1131265614202,0.1236727365991279,0.876327263400872,14043,2,14045,0.9998576005695976,0.0001423994304022,1212312
95672,1034,5342,992,1557,573400.0,108552.75,11008526,7091,6334,1.6666666666666667,6.42741935483871,4.095054592164419,5.282224540603531,49452.386365116385,1552.4645325059937,0.1566150931480896,0.8433849068519104,1220,337,1557,0.783558124598587,0.2164418754014129,335462447
95673,2555,16242,2546,4427,340100.0,71637.75,14317408,19079,18788,0.0,7.382953652788688,4.245990512762593,4.7474969551667945,30422.087594974582,750.4275905445778,0.1355120289546519,0.8644879710453481,4417,10,4427,0.9977411339507568,0.0022588660492432,4313866
95674,73,559,67,161,456300.0,98062.75,756730,788,626,0.0,9.432835820895525,3.9254658385093166,4.653143013019725,39701.1741126735,960.3172588832488,0.1070287539936102,0.8929712460063898,160,1,161,0.9937888198757764,0.0062111801242236,237002
95677,4614,28658,3981,8066,506800.0,89587.0,30895045,42212,32639,1.8,8.35769907058528,4.12496900570295,5.657070780358757,44444.578915698774,731.9019473135601,0.1219706486105579,0.878029351389442,8063,3,8066,0.999628068435408,0.0003719315645921,2862373
95678,6134,43497,6113,11625,426500.0,76922.5,41851698,70347,49610,1.8,8.118926877147064,4.269333333333333,5.54454158406188,37909.24530070087,594.9322359162437,0.1232211247732312,0.8767788752267688,11624,1,11625,0.9999139784946236,8.602150537634408e-05,671985
95681,197,1418,199,400,312700.0,53598.25,1473127,1713,1617,1.8,8.115577889447236,4.0375,5.834145704384005,28716.3373908958,859.9690601284296,0.1230674087816944,0.8769325912183055,397,3,400,0.9925,0.0075,1205950
95682,5451,31747,5260,8821,544400.0,90167.75,53048402,44512,37007,0.0,7.0718631178707225,4.2169822015644485,6.03763540733799,47714.928634916825,1191.7775431344355,0.142135271705353,0.857864728294647,8028,793,8821,0.9101008955900692,0.0898991044099308,755595908
95683,1452,9268,1365,2525,550800.0,114872.0,13474831,11516,10633,0.0,7.853479853479853,4.245544554455446,4.794902151960443,47272.58412494317,1170.0964744703022,0.1283739302172482,0.8716260697827518,2520,5,2525,0.998019801980198,0.0019801980198019,7901465
95684,747,3794,715,1316,460700.0,61307.75,9312779,5649,4509,1.6666666666666667,6.351048951048951,3.4506079027355625,7.514547508267715,41791.921701546635,1648.5712515489467,0.1585717453980927,0.8414282546019073,780,536,1316,0.5927051671732523,0.4072948328267477,354914482
95685,1218,6013,1100,1773,447400.0,57939.5,10617562,8538,7113,0.0,6.573636363636363,4.0783981951494646,7.72184778950457,40794.53738165794,1243.5654720074958,0.1546464220441445,0.8453535779558555,1441,332,1773,0.8127467569091935,0.1872532430908065,282680149
95687,8661,64883,7778,17808,459300.0,88862.0,65644811,94356,72661,0.0,9.455386988943172,4.129829290206649,5.168688528279804,40307.71864227788,695.7142206113019,0.1070450447970713,0.8929549552029287,17806,2,17808,0.9998876909254268,0.0001123090745732,2392967
95688,5241,42318,4918,11364,563300.0,97017.5,50906311,56556,47236,0.0,9.67039446929646,4.185058078141499,5.806168990130646,49056.6345019566,900.1045158780678,0.1041155051232111,0.8958844948767889,11343,21,11364,0.9981520591341078,0.0018479408658922,24890183
95691,5680,38029,5015,10675,412100.0,79495.0,36237012,49353,43044,0.0,8.715653040877369,4.094519906323185,5.183973834832379,36522.51941645626,734.2413227159443,0.1165086887835703,0.8834913112164297,10657,18,10675,0.9983138173302109,0.0016861826697892,2408478
95692,798,4896,710,1334,310900.0,77613.75,4913274,6169,5606,0.0,8.019718309859154,4.268365817091454,4.0057335201559,27612.238845457578,796.445777273464,0.1266500178380306,0.8733499821619694,1331,3,1334,0.9977511244377812,0.0022488755622188,3508213
95693,1109,8175,1027,2211,657600.0,104541.0,12127083,9568,9202,0.0,9.039922103213245,4.199004975124378,6.290354980342641,56898.93230047763,1267.4626881270904,0.1116061725711801,0.8883938274288198,2207,4,2211,0.9981908638625056,0.0018091361374943,3084378
95694,1244,8555,970,2568,474000.0,85509.25,8973568,10952,9525,0.0,10.102061855670105,3.815809968847352,5.543259939714124,41738.65323602031,819.354273192111,0.1018372703412073,0.8981627296587926,2547,21,2568,0.991822429906542,0.0081775700934579,20480738
95695,3635,34346,3647,8989,402800.0,67014.75,31461203,46611,37993,0.0,10.414313134082809,4.225275336522416,6.010617065645996,36246.92100510077,674.9737830125936,0.0959913668307319,0.904008633169268,8985,4,8989,0.9995550116809434,0.0004449883190566,3789502
95701,272,1220,254,410,460400.0,81983.75,3250392,1979,1474,1.8,5.874015748031496,3.6390243902439026,5.615747023038102,40691.952921471835,1642.4416371905002,0.1723202170963365,0.8276797829036635,198,212,410,0.4829268292682926,0.5170731707317073,153725911
95703,549,2093,550,717,534900.0,80923.0,4119398,3163,2643,1.8,4.803636363636364,3.684797768479777,6.609987271851019,47331.03336061862,1302.370534302877,0.2080968596292092,0.7919031403707908,453,264,717,0.6317991631799164,0.3682008368200837,195044252
95709,1398,5464,1324,1793,465300.0,76064.5,11984774,8304,6788,1.6666666666666667,5.182779456193353,3.827105409927496,6.11717686963038,41399.23932674851,1443.2531310211946,0.1950500883912787,0.8049499116087213,1038,755,1793,0.5789180145008366,0.4210819854991634,644978954
95713,2471,9690,2371,3240,422400.0,75676.0,20753366,15488,12061,1.8,5.129059468578658,3.753395061728395,5.581690364184153,37599.41832235069,1339.9642303719008,0.1965840311748611,0.8034159688251389,1867,1373,3240,0.5762345679012346,0.4237654320987654,1060766485
95714,124,610,117,191,343300.0,57162.25,1350689,919,727,0.0,6.273504273504273,3.842931937172775,6.005711811553954,31341.15400024464,1469.7377584330795,0.1609353507565337,0.8390646492434664,116,75,191,0.6073298429319371,0.3926701570680628,56927252
95722,1663,5625,1531,1908,547200.0,94005.0,15324295,8872,7156,0.0,4.760287393860222,3.819706498951782,5.82096696984203,47785.788669453636,1727.2649909828674,0.2139463387367244,0.7860536612632756,971,937,1908,0.5089098532494759,0.4910901467505241,962443336
95726,3217,10852,3076,3858,341300.0,73003.0,25925105,18459,13928,0.0,4.5737971391417425,3.6467081389320897,4.67515033628755,30477.960642535993,1404.469635408202,0.2208500861573808,0.7791499138426192,1716,2142,3858,0.4447900466562986,0.5552099533437014,1430350619
95742,3874,15887,2703,5744,472200.0,133580.75,15581703,20761,18590,0.0,7.310765815760266,3.440285515320334,3.534940476079076,40008.603483723986,750.5275757429796,0.1454007530930607,0.8545992469069392,5744,0,5744,1.0,0.0,$                                   -
95746,4447,27780,4324,7593,852900.0,153422.5,51366456,32995,32104,0.0,7.453052728954671,4.244303964177532,5.559158532809724,71426.47281298153,1556.7951507804212,0.1346872663842512,0.8653127336157488,7470,123,7593,0.9838008692216516,0.0161991307783484,211045900
95747,16679,87548,13010,26770,537300.0,110729.5,87349094,111480,100558,1.8,8.01129900076864,3.893425476279418,4.852365449135054,46259.762714804056,783.5404915679943,0.1293780703673502,0.8706219296326498,26768,2,26770,0.9999252895031752,7.471049682480388e-05,3042274
95757,8811,50298,7467,14819,507100.0,108269.0,51372889,63177,57765,0.0,7.916030534351145,3.988730683581888,4.683704476812384,43744.274764967966,813.1580955094418,0.1292651259413139,0.8707348740586861,14816,3,14819,0.9997975571900938,0.0002024428099062,1671373
95758,9230,67494,8823,18120,434500.0,88453.5,66778026,88332,76317,0.0,8.695908421171938,4.234216335540839,4.912185498595307,38146.71990276593,755.9890639858714,0.1156098903258776,0.8843901096741225,18119,1,18120,0.9999448123620308,5.518763796909492e-05,449547
95762,11075,55220,9690,19078,699100.0,138743.25,91207701,70497,64910,0.0,6.841589267285862,3.474944962784359,5.038803689548861,59043.71122028936,1293.781309842972,0.1492836234786627,0.8507163765213372,18801,277,19078,0.9854806583499318,0.0145193416500681,363141002
95765,7273,40723,6257,11549,578900.0,108293.5,46222542,59797,46980,1.8,7.670768739012306,4.1558576500129885,5.345657864968811,49937.02701636873,772.9909861698748,0.1331843337590464,0.8668156662409536,11548,1,11549,0.9999134124166594,8.658758334054896e-05,792178
95776,3953,22594,2882,6726,429900.0,83743.75,18325450,28464,25476,0.0,9.211311589174183,3.9469223907225697,5.133517426673633,37925.0462793279,643.8114811691962,0.1131260794473229,0.886873920552677,6726,0,6726,1.0,0.0,$                                   -
95811,546,2828,442,872,510900.0,63056.0,4524906,10567,3270,0.0,7.633484162895928,3.869266055045871,8.10232174574981,46227.85373649396,428.21103435222864,0.1351681957186544,0.8648318042813455,861,11,872,0.9873853211009176,0.0126146788990825,4703615
95814,355,2141,357,691,544600.0,36602.25,4253770,11573,2498,0.0,6.991596638655462,3.6121562952243127,14.878866736334516,51827.84517763333,367.55983755292493,0.1429143314651721,0.8570856685348278,682,9,691,0.9869753979739508,0.0130246020260492,996294
95815,3650,18203,3443,5288,247400.0,38563.75,14637717,26112,21646,0.0,6.3470810339819925,4.132564296520424,6.415351204174905,23427.87945270432,560.5743336397059,0.1590594105146447,0.8409405894853552,5250,38,5288,0.9928139183055976,0.0071860816944024,10846122
95816,2153,15035,1857,6262,631100.0,71462.25,18897352,29329,16892,0.0,9.255788906838989,2.7448099648674544,8.831236072191961,56464.54830940159,644.3230931842204,0.1099336964243428,0.8900663035756571,6247,15,6262,0.9976045991695944,0.0023954008304056,6435852
95817,2426,15442,2267,4303,374200.0,49254.25,12773970,21357,17709,0.0,7.88178209086899,4.152451777829421,7.597313937375962,34632.91307423139,598.1163084702907,0.1280140041786662,0.8719859958213337,4280,23,4303,0.9946548919358588,0.0053451080641412,7259109
95818,3114,25378,2907,6950,660600.0,87982.25,29438343,35093,28285,0.0,9.801169590643276,4.099568345323741,7.508332646641795,58024.27415759004,838.8665260878238,0.1027753226091568,0.8972246773908432,6924,26,6950,0.9962589928057554,0.0037410071942446,11010980
95819,2954,25861,2800,6889,637200.0,109857.25,28021975,33182,28661,0.0,10.291071428571428,4.182755116852954,5.800254421078263,54898.2040565702,844.4932493520583,0.097693730155961,0.9023062698440388,6886,3,6889,0.9995645231528524,0.0004354768471476,2649488
95820,6230,38757,5839,10834,317700.0,54008.75,30015480,48595,44596,0.0,7.704572700804932,4.152390622115562,5.88238016987988,29155.07719227312,617.6660150221217,0.1309310252040541,0.8690689747959458,10806,28,10834,0.9974155436588518,0.0025844563411482,7280777
95821,4019,29354,3978,7901,374500.0,45747.5,29618986,41887,33332,0.0,8.389391654097537,4.223895709403873,8.186239685228701,34899.24091945925,707.1164323059661,0.1193447737909516,0.8806552262090483,7887,14,7901,0.9982280723958992,0.0017719276041007,4053697
95822,6420,47714,6236,12926,355400.0,60349.5,41989232,58672,53950,0.0,8.680885182809494,4.1879931920160915,5.889029735126223,32285.880467854273,715.6604854104172,0.1155885078776645,0.8844114921223355,12909,17,12926,0.9986848212904224,0.0013151787095775,7707417
95823,8594,54848,8181,15401,285600.0,49151.0,46443570,73547,63029,0.0,7.754797701992421,4.1193428998117,5.810665093283962,26437.951305027735,631.4815016248114,0.1297973948499897,0.8702026051500104,15388,13,15401,0.9991558989675996,0.0008441010324004,4545065
95824,3791,21610,3565,9166,243800.0,39706.75,15834868,26217,25175,0.0,7.125105189340814,2.7712197250709143,6.140013977472345,23023.29158371305,603.9923713620933,0.1416087388282025,0.8583912611717974,9157,9,9166,0.9990181104080296,0.0009818895919703,3632756
95825,1796,11049,1762,3086,331300.0,43569.75,17829697,40176,12811,0.0,7.290011350737798,4.1623460790667535,7.603899494488722,31014.44752597108,443.7897500995619,0.1375380532355007,0.8624619467644993,3085,1,3086,0.9996759559300064,0.0003240440699935,517300
95826,4543,36425,4491,9710,349300.0,66095.5,34597513,57558,40916,0.0,9.122244488977955,4.219155509783728,5.284777329772829,31471.712195883116,601.0895618332812,0.1097614625085541,0.8902385374914459,9708,2,9710,0.9997940267765192,0.0002059732234809,1009734
95827,2798,19460,2691,5319,328800.0,62400.0,16984728,26302,22151,0.0,8.271274619100707,4.184621169392743,5.269230769230769,29779.046662152858,645.7580412135959,0.1214843573653559,0.878515642634644,5316,3,5319,0.999435984207558,0.0005640157924421,2014944
95828,9149,55073,8483,15541,309800.0,56267.75,45785124,67591,63556,0.0,7.570670753271249,4.132423910945241,5.505818164046012,28323.595605682407,677.3849181103993,0.1334728428472528,0.8665271571527472,15535,6,15541,0.9996139244578855,0.0003860755421144,1804705
95829,5473,31754,4693,9300,429800.0,94802.75,31233876,37489,36447,0.0,7.932452588962284,4.002903225806452,4.533623760914108,37505.82364653755,833.1477500066686,0.1287623123988256,0.8712376876011743,9293,7,9300,0.999247311827957,0.000752688172043,2927469
95831,4582,47406,4453,12404,485300.0,80822.75,52881731,68840,51859,0.0,11.674825960026949,4.1912286359238955,6.004497496063918,42946.85034224108,768.1831929110982,0.0858674482732023,0.9141325517267976,12401,3,12404,0.9997581425346662,0.0002418574653337,1721912
95832,1526,9170,1396,2530,319400.0,52482.75,7171084,10835,10566,0.0,7.66189111747851,4.227667984189723,6.085809146814906,29388.383509846102,661.8443931702815,0.1321219004353587,0.8678780995646413,2527,3,2530,0.998814229249012,0.0011857707509881,1922586
95833,4763,30849,4457,8548,349900.0,67087.0,29115489,51202,35306,0.0,7.990127888714382,4.1661207299953205,5.215615543995111,31483.53523127438,568.6396820436702,0.126239166147397,0.873760833852603,8538,10,8548,0.9988301357042584,0.0011698642957416,1983833
95834,6816,24832,4493,8122,415800.0,72425.25,24120084,42968,29325,0.0,7.043845982639661,3.896577197734548,5.741091677281059,37157.14665645263,561.3499348352262,0.1532139812446717,0.8467860187553282,8119,3,8122,0.999630632849052,0.000369367150948,781680
95835,7251,39857,6447,11572,452000.0,102721.25,43235996,59606,46304,0.0,7.306964479602916,4.070860698237124,4.400257979726687,39168.87702697875,725.3631513606013,0.1392320317899101,0.8607679682100898,11572,0,11572,1.0,0.0,$                                   -
95838,5848,31168,5275,9091,276000.0,49212.75,24220445,38670,36443,0.0,7.017251184834123,4.071719282807172,5.608302726427603,25546.311539346498,626.3368244116887,0.1447465905660895,0.8552534094339105,9048,43,9091,0.995270047299527,0.0047299527004729,10727956
95841,2306,13510,2229,3708,308800.0,52440.0,14162343,23258,15739,0.0,7.095558546433378,4.26537216828479,5.888634630053394,28415.195114318165,608.9235101900422,0.1416227206302814,0.8583772793697185,3706,2,3708,0.999460625674218,0.000539374325782,817088
95842,4184,26429,4053,7322,289300.0,53561.25,22222681,37215,30482,0.0,7.553170490994325,4.180961485932805,5.401292912320008,26569.11826596884,597.1431143356174,0.1329637162915819,0.8670362837084181,7320,2,7322,0.9997268505872712,0.0002731494127287,1385323
95843,6905,42386,6547,11878,361900.0,81729.25,41080046,57755,48933,0.0,7.528791813044142,4.149772689004883,4.428035250537598,31994.929658100733,711.2812050904683,0.1337951893405268,0.8662048106594732,11878,0,11878,1.0,0.0,502150
95864,4089,32016,3955,8501,643200.0,106742.5,44010792,40087,35971,0.0,9.128950695322375,4.247147394424186,6.025716092465513,55552.79811163976,1097.8819068525956,0.1099496816880264,0.8900503183119736,8501,0,8501,1.0,0.0,$                                   -
95912,536,3779,522,1014,351000.0,66991.5,3515183,4240,4301,0.0,8.266283524904214,4.2554240631163704,5.239470679116007,31586.560469346237,829.0525943396226,0.1213671239246686,0.8786328760753314,1011,3,1014,0.9970414201183432,0.0029585798816568,3498998
95916,240,1660,480,254,204800.0,34508.25,3643048,2714,2140,0.0,3.9583333333333335,7.480314960629921,5.934812689719125,19600.048558412545,1342.3168754605747,0.2242990654205607,0.7757009345794392,184,70,254,0.7244094488188977,0.2755905511811024,42603914
95917,470,3151,423,829,275000.0,64996.25,2908447,3664,3574,0.0,8.560283687943262,4.367913148371532,4.231013327691982,24814.82533300248,793.7901200873363,0.1183547845551203,0.8816452154448797,828,1,829,0.9987937273823884,0.0012062726176115,353185
95922,75,567,103,198,266200.0,74678.75,1308479,851,670,0.0,6.233009708737864,3.242424242424242,3.5646017106606633,23723.47970637571,1537.5781433607522,0.1537313432835821,0.8462686567164179,117,81,198,0.5909090909090909,0.4090909090909091,41336862
95926,4237,34033,4107,9061,370500.0,50447.25,34508838,53353,38140,0.0,9.318237156074996,4.223595629621455,7.344305190074781,34214.685422365335,646.8022041872059,0.1076822233875196,0.8923177766124804,9059,2,9061,0.9997792738108376,0.0002207261891623,703747
95928,4576,33099,4423,9016,388800.0,54366.5,37785138,53343,37522,0.0,8.517974225638707,4.178682342502218,7.151462757396558,35658.263634399125,708.3429503402508,0.1178775118597089,0.882122488140291,8952,64,9016,0.9929015084294588,0.0070984915705412,55980157
95932,911,6842,882,1946,285200.0,54146.0,6851470,8163,7724,0.0,8.790249433106576,3.984069886947585,5.26724042403871,26166.48343417795,839.3323533014823,0.1141895390989124,0.8858104609010875,1941,5,1946,0.9974306269270298,0.0025693730729701,3561047
95938,454,3816,455,1036,477700.0,85233.0,4863721,4850,4271,0.0,9.384615384615383,4.121621621621622,5.604636701746976,42076.45050644659,1002.8290721649485,0.1065324280028096,0.8934675719971904,1032,4,1036,0.996138996138996,0.0038610038610038,1508733
95945,5487,27353,5588,8315,391400.0,50354.5,47009013,41843,32941,0.0,5.876879026485326,3.9494888755261575,7.772890208422286,36150.888148310194,1123.4618215711112,0.1696366230533378,0.8303633769466622,6293,2022,8315,0.7568250150330728,0.2431749849669272,1579433417
95946,3174,14585,3118,4337,443600.0,67579.25,27129423,19390,17703,0.0,5.695638229634381,4.094765967258474,6.564145059319244,39888.297436803216,1399.1450747808149,0.1761283398294074,0.8238716601705925,3720,617,4337,0.8577357620474982,0.1422642379525017,550642811
95947,342,2194,393,489,240100.0,41580.5,3136176,2683,2587,1.5,6.4529262086514,5.186094069529652,5.774341337886749,22575.578052622703,1168.9064480059635,0.1519134132199459,0.8480865867800541,431,58,489,0.8813905930470347,0.1186094069529652,29900804
95948,1405,9751,1366,2608,260600.0,57378.5,9009576,11977,11117,0.0,8.166910688140556,4.27760736196319,4.541770872365085,23782.96006993451,752.2397929364615,0.1228748763155527,0.8771251236844473,2605,3,2608,0.9988496932515336,0.0011503067484662,774432
95949,6753,23041,6806,7923,448500.0,76969.5,52060957,36816,29847,0.0,4.377607992947399,3.760444276158021,5.8269834155087405,39862.54038537478,1414.0850988700563,0.2280296177170235,0.7719703822829765,4739,3184,7923,0.5981320206992301,0.4018679793007699,2621659610
95951,216,1986,211,450,240300.0,51032.75,1571644,2349,2197,0.0,10.436018957345972,4.8933333333333335,4.708740955562849,22167.44093258816,669.0693912303108,0.0960400546199362,0.9039599453800636,450,0,450,1.0,0.0,$                                   -
95953,1430,8856,1203,2573,276300.0,59843.25,7815794,10683,10059,0.0,8.550290939318371,3.9976680917217258,4.617062074670075,25119.36032112582,731.6104090611251,0.1195943930808231,0.8804056069191769,2565,8,2573,0.9968907889623008,0.0031092110376991,8593388
95954,2078,13238,3634,3341,194500.0,51266.0,21482159,19423,16872,0.0,4.214639515685195,4.584256210715354,3.793937502438263,17934.890833834892,1106.0165267981258,0.2153864390706496,0.7846135609293504,2289,1052,3341,0.6851242143070937,0.3148757856929063,690639925
95955,115,818,92,189,283100.0,59107.75,808963,1020,910,0.0,10.141304347826088,4.936507936507937,4.789558052878006,25766.540170319386,793.1009803921569,0.1010989010989011,0.8989010989010989,188,1,189,0.9947089947089948,0.0052910052910052,128251
95957,81,423,67,157,278300.0,63125.0,502797,610,490,0.0,7.522388059701493,3.210191082802548,4.408712871287129,25178.975727371595,824.2573770491804,0.136734693877551,0.863265306122449,155,2,157,0.9872611464968152,0.0127388535031847,1129399
95959,4421,22882,4289,7352,519400.0,68257.75,53908974,34670,27171,0.0,6.365819538353929,3.713683351468988,7.609392340063949,46662.280245823094,1554.9170464378426,0.1578521217474513,0.8421478782525487,4486,2866,7352,0.6101741022850925,0.3898258977149075,2465900113
95961,5732,25920,4587,8109,292400.0,58987.25,23119428,32662,30507,0.0,6.900370612600828,3.903317301763473,4.957003420230643,26617.930006742532,707.8387116526851,0.150358934015144,0.8496410659848559,8101,8,8109,0.9990134418547292,0.0009865581452706,1256213
95963,1738,13398,1618,3635,278200.0,50897.5,11640112,16521,15016,0.0,9.354758961681087,4.163961485557084,5.4658873225600475,25669.96323689397,704.5646147327643,0.1077517314864145,0.8922482685135855,3626,9,3635,0.9975240715268224,0.0024759284731774,6629271
95965,2457,16050,2448,4654,216400.0,36212.25,18389787,21094,18498,0.0,7.560049019607843,3.9765792866351526,5.975878328466196,20615.113964113152,871.8017919787617,0.1323386312033733,0.8676613687966267,4448,206,4654,0.955737000429738,0.0442629995702621,104619316
95968,177,1505,189,412,156800.0,30621.75,1454499,1783,1694,0.0,8.899470899470899,4.08252427184466,5.120543404606203,15179.87500379202,815.7593942793045,0.1115702479338843,0.8884297520661157,407,5,412,0.9878640776699028,0.012135922330097,1717117
95969,2877,24350,8358,4036,300000.0,50833.25,32817862,36474,32708,0.0,3.2575975113663556,6.7460356788899905,5.9016490190967525,27684.711142971584,899.7604320886111,0.2555338143573438,0.7444661856426562,3651,385,4036,0.9046085232903864,0.0953914767096134,340924657
95970,38,421,52,125,450000.0,64474.0,405098,531,473,0.0,8.826923076923077,3.672,6.979557651146198,40635.659758012735,762.8964218455744,0.1099365750528541,0.8900634249471459,122,3,125,0.976,0.024,642201
95971,1076,7870,1022,2293,266100.0,54957.5,10665488,9903,8892,1.5,8.753424657534246,3.901439162668992,4.8419233043715595,24380.82365365921,1076.99565788145,0.1149347728295096,0.8850652271704903,2045,248,2293,0.8918447448757086,0.1081552551242913,129177390
95973,5891,37161,5046,10433,402600.0,72033.5,40482146,52517,42207,0.0,8.531906460562823,4.126521614109077,5.589066198366038,35995.00071528629,770.838890264105,0.119553628545028,0.880446371454972,10344,89,10433,0.9914693760184032,0.0085306239815968,70663374
95979,110,902,99,259,250000.0,32927.25,986743,1034,1001,0.0,10.22222222222222,3.907335907335907,7.592495577371326,24033.710579035273,954.2969052224372,0.0989010989010989,0.9010989010989012,250,9,259,0.9652509652509652,0.0347490347490347,10430004
95982,572,3823,538,1035,292700.0,78161.75,3396976,4484,4361,0.0,8.16914498141264,4.246376811594203,3.744798446810621,25979.591988706972,757.5771632471008,0.1233662004127493,0.8766337995872506,1034,1,1035,0.9990338164251208,0.0009661835748792,1776500
95987,616,4562,526,1258,310300.0,69228.5,4095933,5294,5088,0.0,9.844106463878328,4.116057233704293,4.482258029568747,27841.662198574493,773.6934265205894,0.103380503144654,0.8966194968553459,1255,3,1258,0.9976152623211448,0.0023847376788553,1443508
95988,980,7636,903,2061,244100.0,52351.0,6809127,10066,8539,0.0,9.541528239202655,4.180494905385735,4.662757158411492,22465.134207236217,676.4481422610769,0.1057500878322988,0.8942499121677011,2059,2,2061,0.9990295972828724,0.0009704027171276,905194
95991,5217,34156,5017,9303,297900.0,52937.25,30028516,45783,39173,0.0,7.847917081921467,4.232290658927227,5.627417366788037,27388.412716471103,655.8879059913069,0.1280729073596609,0.871927092640339,9298,5,9303,0.999462538965925,0.000537461034075,1655774
95993,5280,36237,5123,9762,353700.0,72223.0,35750079,44670,41360,0.0,8.104040601210228,4.252919483712354,4.897331874887501,31615.60336437656,800.3151779717931,0.1238636363636363,0.8761363636363636,9761,1,9762,0.9998975619750052,0.0001024380249948,204530
96001,6290,40946,6332,11178,319700.0,56863.0,48660018,55917,47278,0.0,7.459886291850916,4.2258006799069605,5.6222851414804005,29200.61340163561,870.2186812597242,0.1339312153644401,0.8660687846355599,11034,144,11178,0.9871175523349436,0.0128824476650563,109135545
96002,5628,35385,5441,9776,280900.0,59996.5,36747537,48306,40826,0.0,7.537768792501378,4.195274140752864,4.68193977982049,25531.62518451543,760.7240715439076,0.1332729143193063,0.8667270856806937,9745,31,9776,0.996828968903437,0.003171031096563,17252203
96003,8086,47999,7772,13591,299600.0,56371.0,58917009,69977,55771,0.0,7.216289243437982,4.126627915532338,5.314789519433751,27386.46606631456,841.9481972648156,0.1393555790643883,0.8606444209356117,13131,460,13591,0.9661540725480096,0.0338459274519902,259848286
96007,3945,25269,3802,7079,235900.0,48310.0,26103231,32536,29071,0.0,7.683850604944766,4.126854075434383,4.8830469882012,21872.17296982613,802.2876506024096,0.1307832547899969,0.8692167452100031,6932,147,7079,0.979234355134906,0.0207656448650939,83909451
96009,54,411,50,107,277800.0,49156.25,471549,565,461,0.0,9.3,4.345794392523365,5.651366815003179,25715.65216063263,834.6,0.1084598698481561,0.8915401301518439,106,1,107,0.9906542056074766,0.0093457943925233,$                                   -
96013,902,5006,861,1399,169500.0,47666.0,5506442,6124,5867,0.0,6.861788617886178,4.2230164403145105,3.5559937901229386,15735.278023493169,899.1577400391901,0.1467530253962843,0.8532469746037157,1326,73,1399,0.947819871336669,0.0521801286633309,42220226
96019,2236,12395,2069,3547,219700.0,50249.5,12231842,15922,14464,0.0,7.071532141130981,4.124894276853679,4.372182807789132,20296.069724284134,768.23527195076,0.1430448008849557,0.8569551991150443,3445,102,3547,0.971243304200733,0.0287566957992669,53494741
96020,800,5100,760,1506,229200.0,62984.0,8042959,6292,5860,1.5,7.763157894736843,3.9176626826029217,3.6390194335069226,20740.88766466564,1278.283375715194,0.1296928327645051,0.8703071672354948,1346,160,1506,0.8937583001328021,0.1062416998671978,152931972
96021,2337,13403,2179,3705,212900.0,45612.75,12176320,16436,15582,1.3333333333333333,7.223497016980266,4.248313090418353,4.6675545762971975,19845.370981049786,740.8323192990995,0.1398408419971762,0.8601591580028237,3651,54,3705,0.9854251012145748,0.0145748987854251,24997236
96022,3332,18963,3138,5370,263300.0,59583.0,23703612,23498,22101,0.0,7.104843849585723,4.151769087523277,4.41904570095497,23946.97524324775,1008.75019150566,0.1419845255870775,0.8580154744129225,5137,233,5370,0.9566108007448788,0.043389199255121,137021329
96023,190,1150,205,316,120300.0,33582.75,1042163,1371,1355,1.8571428571428568,6.536585365853658,4.2405063291139244,3.582196216807736,11543.147195676249,760.1480671043034,0.1512915129151291,0.8487084870848709,310,6,316,0.981012658227848,0.0189873417721519,4233210
96024,104,1277,152,350,278800.0,44626.0,2429376,1712,1429,0.0,9.085526315789474,3.9457142857142857,6.247479048088558,26041.29711441565,1419.0280373831777,0.106368089573128,0.893631910426872,247,103,350,0.7057142857142857,0.2942857142857142,53901584
96025,580,3481,628,1037,232200.0,35885.75,4258951,4634,4109,1.8571428571428568,6.4665605095541405,3.916104146576663,6.470534961649123,22139.386381189983,919.0658178679328,0.1528352397176928,0.8471647602823071,864,173,1037,0.8331726133076182,0.1668273866923818,81742467
96027,311,2594,311,751,240800.0,59029.5,3202496,3132,2905,1.8571428571428568,9.340836012861736,3.868175765645806,4.079316274066357,21919.219560487934,1022.5083014048532,0.1070567986230636,0.8929432013769363,699,52,751,0.9307589880159788,0.0692410119840213,20848549
96032,378,2642,354,779,253400.0,49997.75,3528620,3312,2996,0.0,8.531073446327683,3.876765083440308,5.068228070263162,23420.170660660136,1065.4045893719806,0.1181575433911882,0.8818424566088118,711,68,779,0.9127086007702182,0.0872913992297817,36832102
96034,39,249,46,75,305300.0,40117.25,398499,331,295,1.8571428571428568,6.260869565217392,3.84,7.6101926228742,28803.077785155485,1203.9244712990935,0.1559322033898305,0.8440677966101695,68,7,75,0.9066666666666666,0.0933333333333333,3521554
96035,411,2791,406,754,223500.0,39514.0,2429702,3437,3197,1.3333333333333333,7.886699507389163,4.246684350132626,5.656223110796174,21115.961425826194,706.9252254873436,0.1269940569283703,0.8730059430716296,753,1,754,0.9986737400530504,0.0013262599469496,365250
96038,59,630,84,164,213900.0,53614.5,581687,731,714,1.8571428571428568,8.202380952380953,4.201219512195122,3.98959236773634,19642.640165757097,795.7414500683994,0.1176470588235294,0.8823529411764706,162,2,164,0.9878048780487804,0.0121951219512195,480184
96039,60,711,119,186,143800.0,34715.5,1105068,1051,830,0.0,6.4789915966386555,4.145161290322581,4.142241938039205,13754.26149287256,1051.4443387250235,0.1433734939759036,0.8566265060240964,126,60,186,0.6774193548387096,0.3225806451612903,21617785
96041,317,2543,397,671,310100.0,32041.0,3161506,3029,2940,0.0,7.204030226700252,4.262295081967213,9.678224774507662,29889.814600915342,1043.7457906899967,0.1350340136054421,0.8649659863945578,584,87,671,0.8703427719821163,0.1296572280178837,39223212
96044,237,1337,234,400,177100.0,49637.5,1638593,1691,1571,1.8571428571428568,6.726495726495727,3.935,3.5678670360110805,16379.187910457702,969.0082791247784,0.1489497135582431,0.8510502864417568,379,21,400,0.9475,0.0525,7644569
96050,45,436,52,135,201200.0,27373.0,821233,606,488,0.0,9.25,3.562962962962963,7.350308698352391,19692.066956843268,1355.1699669966997,0.1065573770491803,0.8934426229508197,103,32,135,0.762962962962963,0.237037037037037,12995718
96051,284,2111,340,671,269100.0,54042.25,4295705,2880,2451,0.0,7.044117647058823,3.5692995529061102,4.979437384638871,24693.688542099386,1491.564236111111,0.138718890248878,0.861281109751122,520,151,671,0.7749627421758569,0.225037257824143,86226636
96052,199,2089,225,601,282500.0,45045.5,3143443,2731,2314,0.0,10.168888888888889,3.806988352745425,6.271436658489749,26363.855020146075,1151.0227023068471,0.0972342264477096,0.9027657735522904,465,136,601,0.7737104825291181,0.2262895174708818,66794628
96055,660,3804,660,1073,229300.0,55054.5,3656917,4754,4464,0.0,6.763636363636364,4.160298229263747,4.16496380858967,21005.71115914488,769.2294909549853,0.1478494623655914,0.8521505376344086,1071,2,1073,0.9981360671015844,0.0018639328984156,845262
96057,576,2708,505,793,237500.0,41107.5,4405625,3279,3213,1.8571428571428568,6.5029702970297025,4.141235813366961,5.777534513166697,22355.15909105648,1343.5879841415065,0.1571739807033924,0.8428260192966075,711,82,793,0.8965952080706179,0.1034047919293821,49767071
96062,198,1347,181,377,325000.0,72357.0,2488738,1633,1528,0.0,8.535911602209945,4.098143236074271,4.491617949887364,29045.430905886573,1524.0281690140846,0.1184554973821989,0.881544502617801,353,24,377,0.9363395225464192,0.0636604774535809,22961570
96064,809,5180,741,1429,199100.0,50372.0,5862835,6135,5921,1.8571428571428568,8.082321187584345,4.191042687193842,3.952592710235846,18388.88818948915,955.637326813366,0.1251477790913697,0.8748522209086304,1390,39,1429,0.9727081875437368,0.0272918124562631,28875276
96067,1469,11387,1446,3106,320300.0,49872.75,15272514,14531,12833,0.0,8.89073305670816,4.139085640695428,6.422344867688267,29610.168111796494,1051.0297983621224,0.1126782513831528,0.8873217486168472,3001,105,3106,0.9661944623309724,0.0338055376690276,86510357
96069,166,1102,187,312,327000.0,63840.25,2262105,1384,1289,0.0,6.780748663101604,4.064102564102564,5.122160392542322,29554.94283118228,1634.4689306358382,0.1450737005430566,0.8549262994569433,254,58,312,0.8141025641025641,0.1858974358974359,31254591
96073,967,5744,878,1623,451900.0,96595.0,9192709,6768,6622,0.0,7.643507972665148,4.134935304990758,4.678295978052694,39370.002392528775,1358.2607860520095,0.1325883418906674,0.8674116581093325,1574,49,1623,0.9698089956869994,0.0301910043130006,56222931
96080,4627,31276,4534,8423,250400.0,46170.25,32370871,40058,35810,0.0,7.918614909572121,4.262495547904547,5.423405764534522,23314.513966967676,808.1000299565629,0.1266126780228986,0.8733873219771013,8287,136,8423,0.9838537338240532,0.0161462661759468,79273276
96086,35,338,36,100,225000.0,41552.25,551074,424,374,0.0,10.36111111111111,3.73,5.4148692309080735,21157.141522423295,1299.7028301886792,0.0962566844919786,0.9037433155080212,76,24,100,0.76,0.24,11505404
96088,1237,7375,1240,2140,257200.0,54511.75,12492832,9345,8615,0.0,6.945161290322581,4.024299065420561,4.718248817915404,23582.977650090594,1336.846655965757,0.1439349970980847,0.8560650029019152,1731,409,2140,0.8088785046728972,0.1911214953271028,240048933
96091,173,1894,220,660,321300.0,46645.0,3419650,2561,2114,0.0,9.395454545454545,3.131818181818182,6.888198091971272,29887.47958505895,1335.2791878172588,0.1040681173131504,0.8959318826868495,497,163,660,0.753030303030303,0.2469696969696969,90424870
96093,559,5144,550,1237,298300.0,43944.75,5951959,6559,5694,0.0,10.36909090909091,4.61034761519806,6.788069109506824,27902.786767837883,907.449153834426,0.0965929048120829,0.9034070951879172,1178,59,1237,0.952303961196443,0.0476960388035569,31787136
96094,1374,9550,1329,2607,248600.0,52732.25,11328220,11598,10879,1.8571428571428568,8.219714070729871,4.190257000383583,4.714382564749275,22864.011779506436,976.7390929470598,0.1221619634157551,0.8778380365842449,2536,71,2607,0.9727656309934792,0.0272343690065209,43358585
96096,145,895,144,271,332200.0,54001.25,1925564,1211,1039,0.0,7.222222222222222,3.837638376383764,6.151709451170111,30486.119231296307,1590.0611065235344,0.1385948026948989,0.861405197305101,212,59,271,0.7822878228782287,0.2177121771217712,36954843
96097,1524,11160,1459,3055,190300.0,44178.75,11438742,13997,12619,1.8571428571428568,8.69362577107608,4.151882160392799,4.307500778089014,17791.699189580584,817.2281203114953,0.1156193042237895,0.8843806957762105,2978,77,3055,0.9747954173486088,0.0252045826513911,35060282
96101,985,6403,943,1699,145900.0,47269.0,5732770,7325,7346,1.3333333333333333,7.834570519618239,4.348440258975868,3.086589519558273,13554.93188874576,782.6307167235495,0.128369180506398,0.871630819493602,1678,21,1699,0.9876397881106532,0.0123602118893466,11826520
96103,673,4761,640,1513,352200.0,68189.5,9149800,7141,5401,1.5,8.490625,3.591539986781229,5.165018074630258,31644.07442859712,1281.3051393362275,0.1184965747083873,0.8815034252916126,1223,290,1513,0.8083278255122274,0.1916721744877726,213352674
96104,119,801,103,223,174400.0,42461.5,797986,954,904,1.3333333333333333,8.932038834951456,4.125560538116592,4.107250097146827,16365.824122503816,836.4633123689728,0.1139380530973451,0.8860619469026548,221,2,223,0.9910313901345292,0.0089686098654708,768746
96107,165,1059,178,285,245800.0,47145.75,1412103,1703,1237,0.0,6.876404494382022,4.294736842105263,5.213619467290265,22841.745144840508,829.1855549031121,0.1438965238480194,0.8561034761519806,275,10,285,0.9649122807017544,0.0350877192982456,6913021
96114,525,3844,520,1064,295100.0,80273.0,6198419,4592,4364,0.0,8.401923076923078,4.106203007518797,3.676204950606057,26130.79532629847,1349.8299216027874,0.1191567369385884,0.8808432630614116,1006,58,1064,0.9454887218045112,0.0545112781954887,36608492
96118,285,1991,294,545,215000.0,53025.0,2405374,2400,2285,0.0,7.741496598639456,4.176146788990826,4.054691183404055,19763.720076163565,1002.2391666666666,0.1286652078774617,0.8713347921225383,523,22,545,0.9596330275229358,0.0403669724770642,16716229
96120,260,1444,262,466,375300.0,65754.5,3244267,1936,1706,1.4,6.5038167938931295,3.6566523605150216,5.70759415705389,33830.06228392634,1675.7577479338845,0.1535756154747948,0.8464243845252052,335,131,466,0.7188841201716738,0.2811158798283262,98082244
96122,892,5594,839,1685,198000.0,51710.0,8155668,7177,6433,1.5,7.730631704410012,3.849258160237389,3.8290466060723265,18243.120317237685,1136.361711021318,0.1304212653505363,0.8695787346494637,1425,260,1685,0.8456973293768546,0.1543026706231454,188818782
96130,2623,18571,2603,4937,218100.0,58585.5,20343643,23101,21174,0.0,8.142143680368806,4.2928904192829656,3.722764165194459,19866.56788708668,880.6390632440155,0.1229337867195617,0.8770662132804383,4849,88,4937,0.9821754101681184,0.0178245898318817,50698640
96134,213,1551,245,406,130100.0,40717.5,1365838,1779,1796,1.8571428571428568,7.2,4.344827586206897,3.1951863449376803,12256.91867098586,767.7560427206296,0.1364142538975501,0.8635857461024499,404,2,406,0.9950738916256158,0.0049261083743842,323750
96140,878,4522,757,1394,721200.0,79602.25,12149063,6675,5279,0.0,7.133421400264201,3.873744619799139,9.060045413289195,63908.98828229755,1820.0843445692883,0.1433983709035802,0.8566016290964198,1023,371,1394,0.7338593974175036,0.2661406025824964,461824397
96142,931,5337,788,1543,577700.0,69179.25,13188712,7636,6125,1.6666666666666667,7.9543147208121825,4.062216461438756,8.35076992017115,51837.43266602391,1727.1754845468831,0.1286530612244898,0.8713469387755102,1290,253,1543,0.8360337005832793,0.1639662994167206,298375170
96143,768,4378,790,1271,542100.0,51251.5,10073244,7693,5168,0.0,6.5139240506329115,4.048780487804878,10.577251397520072,49988.47265974909,1309.4038736513714,0.1528637770897832,0.8471362229102167,896,375,1271,0.7049567269866247,0.2950432730133753,371670651
96145,1555,8787,1609,2672,785700.0,87026.0,32175843,16544,10396,0.0,6.427594779366066,3.870508982035928,9.02833635924896,69078.82986931052,1944.8647848162475,0.1547710657945363,0.8452289342054636,1803,869,2672,0.6747754491017964,0.3252245508982035,1078592889
96146,623,3749,821,1470,1203900.0,80299.5,14794212,8276,4570,0.0,5.325213154689403,2.9741496598639454,14.99262137373209,106600.96599033687,1787.60415659739,0.1796498905908096,0.8203501094091904,938,532,1470,0.638095238095238,0.3619047619047619,833001656
96148,476,2226,394,755,681100.0,78381.0,5871798,3770,2620,0.0,6.8578680203045685,3.5788079470198677,8.689605899388882,60438.33903208037,1557.506100795756,0.150381679389313,0.849618320610687,538,217,755,0.7125827814569536,0.2874172185430463,258800029
96150,9270,53109,9742,16129,488200.0,61085.0,93760320,73114,62851,0.0,6.403099979470334,3.86750573501147,7.992142097077842,44301.18352021658,1282.3853160817357,0.1550015115113522,0.8449984884886478,13422,2707,16129,0.8321656643313287,0.1678343356686713,2421196329
96161,8432,42685,8287,13325,653600.0,100105.25,116696623,64403,50972,0.0,6.168335947870158,3.836172607879925,6.529128092682452,56765.78793252661,1811.974954582861,0.1625794553872714,0.8374205446127285,10210,3115,13325,0.7662288930581613,0.2337711069418386,4391342786
