,ZIP Code,new_policies,renewed_policies,company_nonrenewed,owner_nonrenewed,nonrenewed_policies,expiring_policies,pct_nonrenewed_policies,pct_nonrenewed_owner,pct_nonrenewed_company,ratio_new_to_nonrenewed
0,90001,3162,22127,1780,1073,2853,24980,0.11421136909527622,0.04295436349079263,0.07125700560448359,1.1083070452155626
1,90002,3448,21908,2091,1022,3113,25021,0.12441549098757045,0.0408456896207186,0.08356980136685184,1.1076132348217154
2,90003,4525,26933,2667,1304,3971,30904,0.12849469324359306,0.04219518508930883,0.08629950815428424,1.1395114580710148
3,90004,2182,15683,1704,434,2138,17821,0.11997082094158577,0.02435329106110768,0.09561752988047809,1.0205799812909262
4,90005,521,3357,384,125,509,3866,0.13166063114330057,0.03233316088980859,0.09932747025349198,1.0235756385068762
5,90006,1224,6790,750,339,1089,7879,0.1382155095824343,0.04302576469095063,0.09518974489148369,1.1239669421487604
6,90007,1143,7147,723,268,991,8138,0.12177439174244287,0.03293192430572622,0.08884246743671664,1.153380423814329
7,90008,2012,17624,1528,375,1903,19527,0.09745480616582168,0.01920417882931326,0.07825062733650842,1.0572779821334735
8,90010,20,122,24,3,27,149,0.18120805369127516,0.020134228187919462,0.1610738255033557,0.7407407407407407
9,90011,5015,30290,2892,1550,4442,34732,0.12789358516641713,0.044627432914891164,0.08326615225152598,1.128995947771274
10,90012,296,2660,225,54,279,2939,0.09493024838380401,0.01837359646138142,0.07655665192242259,1.060931899641577
11,90013,45,327,39,5,44,371,0.11859838274932614,0.013477088948787063,0.10512129380053908,1.0227272727272727
12,90014,25,145,23,1,24,169,0.14201183431952663,0.005917159763313609,0.13609467455621302,1.0416666666666667
13,90015,217,1379,179,49,228,1607,0.14187927815805848,0.030491599253266957,0.11138767890479154,0.9517543859649122
14,90016,3333,24413,2430,634,3064,27477,0.11151144593660152,0.02307384357826546,0.08843760235833606,1.087793733681462
15,90017,107,493,67,22,89,582,0.15292096219931273,0.037800687285223365,0.11512027491408934,1.202247191011236
16,90018,3082,21282,2101,693,2794,24076,0.11604917760425319,0.0287838511380628,0.0872653264661904,1.1030780243378668
17,90019,3923,27316,2919,795,3714,31030,0.11969062197873026,0.025620367386400257,0.09407025459233,1.0562735595045774
18,90020,350,2746,297,68,365,3111,0.117325618772099,0.02185792349726776,0.09546769527483125,0.958904109589041
19,90021,33,408,32,16,48,456,0.10526315789473684,0.03508771929824561,0.07017543859649122,0.6875
20,90022,3482,33260,2227,985,3212,36472,0.08806755867514805,0.027007019083132265,0.061060539592015795,1.0840597758405977
21,90023,2049,16768,1266,627,1893,18661,0.10144150902952682,0.03359948555811586,0.06784202347141097,1.0824088748019018
22,90024,1235,11319,1086,242,1328,12647,0.10500513955878865,0.01913497272080335,0.08587016683798529,0.9299698795180723
23,90025,1222,10779,990,202,1192,11971,0.09957397042853562,0.016874112438392784,0.08269985799014284,1.0251677852348993
24,90026,4099,30659,3145,688,3833,34492,0.1111272179056013,0.0199466542966485,0.0911805636089528,1.0693973388990348
25,90027,2527,19412,1957,462,2419,21831,0.11080573496404196,0.021162566991892263,0.08964316797214969,1.0446465481603968
26,90028,414,2325,308,94,402,2727,0.1474147414741474,0.03447011367803447,0.11294462779611295,1.0298507462686568
27,90029,1093,7555,816,184,1000,8555,0.11689070718877849,0.021507890122735244,0.09538281706604325,1.093
28,90031,1968,17301,1354,407,1761,19062,0.09238275102297765,0.02135137970832022,0.07103137131465743,1.1175468483816013
29,90032,3240,27438,2268,795,3063,30501,0.10042293695288679,0.02606471918953477,0.07435821776335202,1.0577864838393731
30,90033,1743,13034,1126,514,1640,14674,0.1117623006678479,0.03502794057516696,0.07673436009268093,1.0628048780487804
31,90034,2165,18900,1815,328,2143,21043,0.10183909138430833,0.015587131112483962,0.08625196027182436,1.0102659822678488
32,90035,2037,15402,1670,342,2012,17414,0.11553922131618238,0.019639370621339153,0.09589985069484323,1.0124254473161034
33,90036,1761,12840,1395,357,1752,14592,0.12006578947368421,0.02446546052631579,0.09560032894736842,1.00513698630137
34,90037,3280,19294,1998,900,2898,22192,0.13058759913482337,0.040555155010814706,0.09003244412400865,1.1318150448585231
35,90038,878,5148,646,162,808,5956,0.1356615177971793,0.02719946272666219,0.10846205507051712,1.0866336633663367
36,90039,3118,25960,2386,534,2920,28880,0.10110803324099724,0.018490304709141273,0.08261772853185595,1.0678082191780822
37,90040,813,7439,534,210,744,8183,0.09092020041549553,0.02566295979469632,0.06525724062079921,1.092741935483871
38,90041,2434,22054,1855,366,2221,24275,0.09149330587023687,0.015077239958805356,0.07641606591143152,1.0959027465105808
39,90042,4388,35646,3191,739,3930,39576,0.09930260764099454,0.018672933090762078,0.08062967455023247,1.1165394402035624
40,90043,4315,35756,3021,937,3958,39714,0.09966258750062951,0.02359369491866848,0.07606889258196102,1.0901970692268823
41,90044,5932,41702,3668,1585,5253,46955,0.11187306996060058,0.03375572356511554,0.07811734639548504,1.1292594707786028
42,90045,3499,34001,2995,444,3439,37440,0.09185363247863249,0.011858974358974358,0.07999465811965811,1.0174469322477464
43,90046,3616,20113,2422,1047,3469,23582,0.1471037231786956,0.0443982698668476,0.10270545331184802,1.0423753243009513
44,90047,5127,41448,3399,1182,4581,46029,0.0995242129961546,0.025679462947272372,0.07384475004888223,1.1191879502292077
45,90048,2001,12852,1634,362,1996,14848,0.13442887931034483,0.024380387931034482,0.11004849137931035,1.00250501002004
46,90049,3512,26250,2514,1082,3596,29846,0.12048515713998526,0.03625276418950613,0.08423239295047913,0.9766407119021134
47,90056,857,8724,702,165,867,9591,0.09039724741945573,0.017203628401626526,0.07319361901782921,0.9884659746251442
48,90057,277,1477,203,52,255,1732,0.14722863741339492,0.03002309468822171,0.11720554272517321,1.0862745098039215
49,90058,68,400,23,25,48,448,0.10714285714285714,0.05580357142857143,0.05133928571428571,1.4166666666666667
50,90059,3001,19704,1861,831,2692,22396,0.1202000357206644,0.03710484015002679,0.08309519557063762,1.1147845468053492
51,90061,1787,13541,1165,490,1655,15196,0.10891023953672019,0.03224532771782048,0.07666491181889971,1.0797583081570996
52,90062,2638,17656,1613,691,2304,19960,0.1154308617234469,0.03461923847695391,0.08081162324649299,1.1449652777777777
53,90063,3508,24843,2154,994,3148,27991,0.11246472080311529,0.0355114143831946,0.0769533064199207,1.1143583227445997
54,90064,2629,23826,2210,374,2584,26410,0.09784172661870504,0.014161302536917834,0.0836804240817872,1.0174148606811146
55,90065,3799,34204,2813,780,3593,37797,0.09506045453342858,0.0206365584570204,0.07442389607640817,1.0573337044252713
56,90066,4177,38888,3492,612,4104,42992,0.095459620394492,0.014235206550055824,0.08122441384443617,1.0177875243664718
57,90067,62,502,108,17,125,627,0.19936204146730463,0.02711323763955343,0.1722488038277512,0.496
58,90068,3236,19527,2174,861,3035,22562,0.1345182164701711,0.03816151050438791,0.09635670596578318,1.0662273476112025
59,90069,1617,9423,1194,459,1653,11076,0.14924160346695559,0.0414409534127844,0.10780065005417118,0.9782214156079855
60,90077,1579,9655,864,744,1608,11263,0.14276835656574624,0.06605700079907663,0.07671135576666963,0.9819651741293532
61,90094,354,1759,269,31,300,2059,0.14570179698882954,0.015055852355512385,0.13064594463331713,1.18
62,90201,3648,40337,2558,840,3398,43735,0.07769520978621242,0.019206585114896535,0.05848862467131588,1.0735726898175397
63,90210,3183,20296,2019,1379,3398,23694,0.14341183421963366,0.05820038828395374,0.08521144593567992,0.9367274867569159
64,90211,648,4462,537,109,646,5108,0.1264682850430697,0.02133907595927956,0.10512920908379013,1.0030959752321982
65,90212,584,4999,466,114,580,5579,0.10396128338411902,0.020433769492740634,0.08352751389137839,1.006896551724138
66,90220,4094,31345,2811,995,3806,35151,0.10827572473044864,0.02830644931865381,0.07996927541179483,1.0756699947451394
67,90221,3144,26648,2008,751,2759,29407,0.09382119903424355,0.025538137178222873,0.06828306185602068,1.1395433127944907
68,90222,2373,17355,1540,612,2152,19507,0.11031937253293689,0.031373353155277596,0.0789460193776593,1.1026951672862453
69,90230,1940,19662,1592,313,1905,21567,0.08832939212686049,0.014512913247090461,0.07381647887977003,1.0183727034120735
70,90232,1253,12297,1009,202,1211,13508,0.08965057743559372,0.014954101273319514,0.0746964761622742,1.0346820809248556
71,90240,2393,20988,1842,418,2260,23248,0.09721266345492086,0.017980041293874743,0.07923262216104611,1.058849557522124
72,90241,2832,27352,2218,482,2700,30052,0.08984426993211767,0.016038865965659524,0.07380540396645814,1.048888888888889
73,90242,2659,27186,2121,414,2535,29721,0.0852932270112042,0.013929544766326839,0.07136368224487737,1.0489151873767257
74,90245,1171,12731,1007,108,1115,13846,0.080528672540806,0.00780008666762964,0.07272858587317636,1.0502242152466368
75,90247,2489,25252,1886,525,2411,27663,0.08715612912554675,0.018978418826591476,0.06817771029895528,1.0323517212774782
76,90248,859,8946,688,178,866,9812,0.08825927435792906,0.01814105177333877,0.0701182225845903,0.9919168591224018
77,90249,1972,20539,1562,351,1913,22452,0.0852039907357919,0.015633351149118117,0.0695706395866738,1.0308416100365918
78,90250,4663,47124,3679,712,4391,51515,0.08523730952149859,0.013821217121226827,0.07141609240027176,1.0619448872694146
79,90254,1933,19849,1626,252,1878,21727,0.08643623141713076,0.011598471947346619,0.07483775946978415,1.0292864749733759
80,90255,2855,29554,1877,744,2621,32175,0.08146076146076146,0.023123543123543124,0.05833721833721834,1.0892789011827546
81,90260,2323,23831,1886,352,2238,26069,0.0858490927922053,0.013502627642026928,0.07234646515017837,1.0379803395889187
82,90262,3137,31719,2228,818,3046,34765,0.08761685603336689,0.023529411764705882,0.064087444268661,1.0298752462245568
83,90265,2532,16548,1824,1043,2867,19415,0.1476693278392995,0.053721349472057686,0.09394797836724182,0.8831531217300314
84,90266,4242,42425,3778,536,4314,46739,0.09229979246453711,0.011467938980294828,0.08083185348424228,0.9833101529902643
85,90270,1063,11772,735,252,987,12759,0.07735715965201034,0.019750764166470727,0.05760639548553962,1.077001013171226
86,90272,3190,25881,2295,969,3264,29145,0.11199176531137417,0.033247555326814206,0.07874420998455996,0.977328431372549
87,90274,3442,31981,2865,543,3408,35389,0.09630111051456668,0.015343750883042753,0.08095735963152392,1.0099765258215962
88,90275,4909,47105,4031,794,4825,51930,0.09291353745426535,0.015289813210090507,0.07762372424417485,1.0174093264248705
89,90277,2688,27063,2244,308,2552,29615,0.08617254769542462,0.010400135066689178,0.07577241262873544,1.0532915360501567
90,90278,3345,34529,2900,421,3321,37850,0.08774108322324967,0.011122853368560106,0.07661822985468957,1.007226738934056
91,90280,4879,51597,3480,1115,4595,56192,0.08177320615034168,0.01984268223234624,0.061930523917995445,1.0618063112078346
92,90290,1085,4552,540,415,955,5507,0.17341565280552024,0.07535863446522607,0.09805701834029418,1.1361256544502618
93,90291,3152,24905,2693,494,3187,28092,0.11344866866011676,0.017585077602164316,0.09586359105795245,0.9890178851584562
94,90292,723,5218,647,115,762,5980,0.1274247491638796,0.019230769230769232,0.10819397993311036,0.9488188976377953
95,90293,775,6287,682,101,783,7070,0.11074964639321075,0.014285714285714285,0.09646393210749646,0.9897828863346104
96,90301,1412,13560,949,253,1202,14762,0.08142528112721853,0.01713859910581222,0.06428668202140632,1.1747088186356074
97,90302,1259,12230,952,281,1233,13463,0.09158434227141053,0.02087201960929956,0.07071232266211097,1.0210867802108679
98,90303,1457,15271,1046,333,1379,16650,0.08282282282282283,0.02,0.06282282282282282,1.056562726613488
99,90304,1115,11832,805,193,998,12830,0.07778643803585347,0.01504286827747467,0.0627435697583788,1.1172344689378757
100,90305,1339,13191,995,318,1313,14504,0.09052675124103696,0.021924986210700496,0.06860176503033646,1.0198019801980198
101,90401,80,597,73,19,92,689,0.13352685050798258,0.027576197387518143,0.10595065312046444,0.8695652173913043
102,90402,1330,12903,1121,295,1416,14319,0.09888958726168029,0.02060199734618339,0.07828758991549689,0.9392655367231638
103,90403,670,6659,567,112,679,7338,0.0925320250749523,0.015263014445352958,0.07726901062959934,0.9867452135493373
104,90404,537,5760,463,114,577,6337,0.09105254852453842,0.01798958497711851,0.07306296354741991,0.9306759098786829
105,90405,1622,17234,1427,245,1672,18906,0.08843753305828837,0.012958849042631969,0.07547868401565641,0.9700956937799043
106,90501,2749,28066,2184,413,2597,30663,0.08469490917392297,0.013469001728467534,0.07122590744545544,1.0585290720061609
107,90502,1292,11729,1031,186,1217,12946,0.09400587053916268,0.014367372161285339,0.07963849837787734,1.0616269515201315
108,90503,2629,31562,2258,327,2585,34147,0.075702111459279,0.009576243886725042,0.06612586757255395,1.0170212765957447
109,90504,2438,29698,2095,370,2465,32163,0.07664086061623605,0.011503901999191617,0.06513695861704442,0.9890466531440162
110,90505,2900,32336,2541,371,2912,35248,0.082614616432138,0.01052541988197912,0.07208919655015887,0.9958791208791209
111,90601,2860,26659,2142,608,2750,29409,0.09350878982624367,0.020673943350674965,0.0728348464755687,1.04
112,90602,1898,15412,1340,356,1696,17108,0.09913490764554594,0.020808978255786766,0.07832592938975917,1.1191037735849056
113,90603,2007,21892,1689,293,1982,23874,0.0830191840495937,0.012272765351428332,0.07074641869816536,1.0126135216952574
114,90604,3454,32491,2697,546,3243,35734,0.09075390384507752,0.015279565679744781,0.07547433816533274,1.0650632130743138
115,90605,3357,32570,2588,687,3275,35845,0.09136560189705677,0.019165852978100154,0.07219974891895661,1.0250381679389313
116,90606,2652,25488,1991,583,2574,28062,0.09172546504169339,0.02077542584277671,0.07095003919891668,1.0303030303030303
117,90620,4494,41279,3599,775,4374,45653,0.09580969487218803,0.0169758832935404,0.07883381157864762,1.027434842249657
118,90621,2037,14248,1560,385,1945,16193,0.1201136293460137,0.023775705551781635,0.09633792379423207,1.0473007712082263
119,90623,1280,14233,1124,173,1297,15530,0.08351577591757887,0.011139729555698648,0.07237604636188023,0.9868928296067849
120,90630,4156,40645,3528,573,4101,44746,0.09165065033746034,0.012805613909623207,0.07884503642783712,1.013411363082175
121,90631,5991,50103,4693,1331,6024,56127,0.10732802394569459,0.0237140770039375,0.08361394694175708,0.9945219123505976
122,90638,4842,45794,3946,683,4629,50423,0.09180334371219483,0.013545405866370505,0.07825793784582433,1.0460142579390797
123,90640,3556,37050,2753,673,3426,40476,0.08464275126000594,0.016627137068880325,0.0680156141911256,1.0379451255107999
124,90650,7420,73058,5824,1407,7231,80289,0.090062150481386,0.017524193849717894,0.0725379566316681,1.026137463697967
125,90660,4480,46300,3286,915,4201,50501,0.08318647155501871,0.018118453099938616,0.0650680184550801,1.0664127588669365
126,90670,1317,11710,1035,229,1264,12974,0.09742562047171266,0.017650685987359332,0.07977493448435333,1.0419303797468353
127,90680,1905,12785,1392,347,1739,14524,0.11973285596254475,0.023891489947672817,0.09584136601487193,1.0954571592869464
128,90701,1303,12660,1070,241,1311,13971,0.0938372342709899,0.017250017894209435,0.07658721637678047,0.9938977879481312
129,90703,4483,50135,3806,579,4385,54520,0.08042920029347028,0.01061995597945708,0.06980924431401321,1.0223489167616875
130,90704,210,1759,125,109,234,1993,0.11741093828399397,0.05469141996989463,0.06271951831409935,0.8974358974358975
131,90706,4368,43911,3452,697,4149,48060,0.08632958801498128,0.014502704952143154,0.07182688306283812,1.0527838033261028
132,90710,2049,16590,1490,296,1786,18376,0.09719198955158903,0.01610796691336526,0.08108402263822377,1.1472564389697648
133,90712,3461,35542,2948,439,3387,38929,0.08700454673893498,0.011276940070384546,0.07572760666855044,1.0218482432831415
134,90713,3231,35327,2815,363,3178,38505,0.08253473574860408,0.00942734709777951,0.07310738865082457,1.0166771554436753
135,90715,1338,13392,1130,182,1312,14704,0.08922742110990206,0.012377584330794342,0.07684983677910773,1.0198170731707317
136,90716,708,6669,489,149,638,7307,0.08731353496647051,0.020391405501573832,0.06692212946489667,1.109717868338558
137,90717,1721,17059,1450,241,1691,18750,0.09018666666666666,0.012853333333333333,0.07733333333333334,1.0177409816676524
138,90720,2377,21801,1859,245,2104,23905,0.08801505961096005,0.010248901903367497,0.07776615770759256,1.1297528517110267
139,90723,2436,23777,1840,507,2347,26124,0.08984075945490737,0.019407441433164904,0.07043331802174246,1.037920749893481
140,90731,4230,38118,3426,611,4037,42155,0.09576562685327956,0.014494128810342783,0.08127149804293678,1.0478077780530097
141,90732,1786,17731,1464,219,1683,19414,0.08669001751313485,0.011280519212939115,0.07540949830019573,1.0612002376708258
142,90740,1735,18241,1485,194,1679,19920,0.08428714859437751,0.009738955823293172,0.07454819277108433,1.0333531864204883
143,90742,181,1183,156,28,184,1367,0.1346013167520117,0.020482809070958303,0.1141185076810534,0.9836956521739131
144,90743,84,679,69,17,86,765,0.11241830065359477,0.022222222222222223,0.09019607843137255,0.9767441860465116
145,90744,2529,25710,1829,456,2285,27995,0.08162171816395784,0.016288622968387213,0.06533309519557064,1.1067833698030634
146,90745,3887,39775,2953,583,3536,43311,0.08164207707049018,0.01346078363464247,0.06818129343584771,1.099264705882353
147,90746,2803,26226,2103,554,2657,28883,0.09199182910362497,0.019180833015960946,0.07281099608766402,1.0549491908167106
148,90755,812,6361,606,92,698,7059,0.09888086131180054,0.013033007508145629,0.08584785380365491,1.163323782234957
149,90802,1031,7990,959,116,1075,9065,0.11858797573083288,0.012796469939327083,0.10579150579150579,0.9590697674418605
150,90803,3056,29377,2659,342,3001,32378,0.09268639199456422,0.010562727778120947,0.08212366421644327,1.0183272242585806
151,90804,1914,16766,1541,269,1810,18576,0.09743755383290267,0.01448105081826012,0.08295650301464255,1.0574585635359115
152,90805,5902,54114,4351,1116,5467,59581,0.09175743945217435,0.018730803444050956,0.0730266360081234,1.0795683190049388
153,90806,2298,22469,1782,398,2180,24649,0.08844172177370278,0.016146699663272344,0.07229502211043044,1.0541284403669724
154,90807,2641,27392,2230,334,2564,29956,0.0855922018961143,0.011149686206436107,0.07444251568967819,1.03003120124805
155,90808,4567,50316,3956,512,4468,54784,0.08155665887850468,0.009345794392523364,0.07221086448598131,1.0221575649059982
156,90810,2355,23873,1706,441,2147,26020,0.08251345119139124,0.01694850115295926,0.06556495003843198,1.096879366557988
157,90813,1780,14768,1426,337,1763,16531,0.10664811566148448,0.020385941564333675,0.08626217409715081,1.0096426545660806
158,90814,1377,14129,1201,160,1361,15490,0.08786313750806972,0.010329244673983214,0.0775338928340865,1.011756061719324
159,90815,3872,41613,3359,459,3818,45431,0.08403953247782352,0.01010323347494002,0.0739362990028835,1.0141435306443165
160,91001,4543,40896,3282,1033,4315,45211,0.09544137488664263,0.022848421844241445,0.07259295304240118,1.0528389339513327
161,91006,3851,31888,3156,585,3741,35629,0.1049987369839176,0.016419209071262174,0.08857952791265541,1.029403902699813
162,91007,2645,22202,2198,360,2558,24760,0.10331179321486268,0.014539579967689823,0.08877221324717285,1.0340109460516027
163,91008,175,1096,90,52,142,1238,0.1147011308562197,0.0420032310177706,0.07269789983844911,1.232394366197183
164,91010,2094,19829,1569,406,1975,21804,0.09057971014492754,0.01862043661713447,0.07195927352779306,1.060253164556962
165,91011,2895,23603,2238,595,2833,26436,0.10716447268875776,0.02250718716901195,0.0846572855197458,1.0218849276385458
166,91016,3606,35182,2856,599,3455,38637,0.08942205657789166,0.015503274063721303,0.07391878251417036,1.0437047756874096
167,91020,468,4409,359,91,450,4859,0.09261164848734307,0.01872813336077382,0.07388351512656925,1.04
168,91024,1327,12399,1040,242,1282,13681,0.09370660039470799,0.017688765441122724,0.07601783495358526,1.0351014040561624
169,91030,1701,19728,1398,287,1685,21413,0.0786905151076449,0.013403072899640406,0.06528744220800449,1.0094955489614243
170,91040,3019,20930,2152,720,2872,23802,0.12066212923283758,0.030249558860599948,0.09041257037223763,1.051183844011142
171,91042,3304,22401,2396,708,3104,25505,0.12170162713193491,0.027759262889629484,0.09394236424230543,1.0644329896907216
172,91101,403,2914,279,50,329,3243,0.10144927536231885,0.015417823003391921,0.08603145235892692,1.2249240121580547
173,91103,2165,17663,1638,481,2119,19782,0.10711758163987463,0.024315033869173996,0.08280254777070063,1.0217083529966966
174,91104,3267,32906,2701,502,3203,36109,0.08870364729014928,0.013902351214378687,0.07480129607577059,1.0199812675616609
175,91105,1258,11527,1047,249,1296,12823,0.10106839273181002,0.01941823286282461,0.08165015986898541,0.970679012345679
176,91106,1397,13156,1117,200,1317,14473,0.09099702895045948,0.013818835072203413,0.07717819387825606,1.0607441154138193
177,91107,3673,34159,2917,611,3528,37687,0.09361318226444132,0.016212487064505003,0.07740069519993632,1.0410997732426304
178,91108,1890,16663,1573,329,1902,18565,0.10245084837058982,0.017721518987341773,0.08472932938324805,0.9936908517350158
179,91201,1637,13500,1290,289,1579,15079,0.10471516678824856,0.019165727170236752,0.0855494396180118,1.0367321089297024
180,91202,1615,12918,1239,284,1523,14441,0.10546361055328578,0.019666228100547054,0.08579738245273873,1.0604070912672356
181,91203,409,3822,333,68,401,4223,0.0949561922803694,0.01610229694529955,0.07885389533506985,1.0199501246882794
182,91204,362,3502,283,69,352,3854,0.09133367929423974,0.017903476907109497,0.07343020238713026,1.0284090909090908
183,91205,1108,11148,913,176,1089,12237,0.08899240009806325,0.014382610116858707,0.07460978998120454,1.017447199265381
184,91206,2100,15090,1439,584,2023,17113,0.11821422310524163,0.034126102962659964,0.08408812014258166,1.0380622837370241
185,91207,1156,9298,851,280,1131,10429,0.108447598043916,0.026848211717326684,0.08159938632658932,1.02210433244916
186,91208,2171,15504,1444,618,2062,17566,0.1173858590458841,0.03518160081976546,0.08220425822611864,1.0528612997090203
187,91210,2,31,3,0,3,34,0.08823529411764706,0.0,0.08823529411764706,0.6666666666666666
188,91214,3934,31723,2983,713,3696,35419,0.10435077218442079,0.020130438465230525,0.08422033371919027,1.0643939393939394
189,91301,3407,25053,2591,871,3462,28515,0.12140978432403998,0.030545327020866212,0.09086445730317377,0.9841132293471981
190,91302,4177,23501,2535,1615,4150,27651,0.15008498788470578,0.0584065675744096,0.09167842031029619,1.0065060240963855
191,91303,1352,8552,1014,224,1238,9790,0.12645556690500512,0.022880490296220635,0.10357507660878447,1.0920840064620356
192,91304,4913,32042,3770,756,4526,36568,0.123769415882739,0.020673813169984685,0.10309560271275432,1.085505965532479
193,91306,4332,31894,3409,647,4056,35950,0.11282336578581363,0.01799721835883171,0.09482614742698192,1.0680473372781065
194,91307,4262,28802,3242,748,3990,32792,0.12167601854110759,0.022810441571114906,0.09886557696999268,1.068170426065163
195,91311,4467,29821,3368,770,4138,33959,0.12185282252127566,0.022674401484142643,0.09917842103713301,1.0795070082165297
196,91316,3227,19472,2475,667,3142,22614,0.1389404793490758,0.029495003095427613,0.10944547625364819,1.0270528325907065
197,91320,5899,46486,4716,1139,5855,52341,0.11186259337804016,0.02176114327200474,0.09010145010603542,1.0075149444918872
198,91321,2656,18511,1893,715,2608,21119,0.12349069558217719,0.03385576968606468,0.08963492589611251,1.01840490797546
199,91324,2639,18964,2097,379,2476,21440,0.11548507462686568,0.01767723880597015,0.09780783582089553,1.065831987075929
200,91325,2947,21785,2272,416,2688,24473,0.1098353287296204,0.016998324684346013,0.09283700404527438,1.0963541666666667
201,91326,6001,36924,4196,1005,5201,42125,0.12346587537091988,0.023857566765578635,0.09960830860534124,1.1538165737358201
202,91331,5769,50447,4059,1337,5396,55843,0.0966280464874738,0.02394212345325287,0.07268592303422095,1.0691252779836917
203,91335,6359,44318,4766,1104,5870,50188,0.1169602295369411,0.021997290188889775,0.09496293934805132,1.083304940374787
204,91340,2384,20012,1662,548,2210,22222,0.0994509945099451,0.024660246602466025,0.07479074790747907,1.078733031674208
205,91342,8396,58120,5724,2087,7811,65931,0.11847234229725015,0.03165430525852785,0.0868180370387223,1.0748943797209065
206,91343,4534,33319,3522,737,4259,37578,0.11333759114375433,0.01961253925168982,0.09372505189206451,1.0645691476872505
207,91344,6950,50920,5416,1171,6587,57507,0.11454257742535691,0.020362738449232268,0.09417983897612464,1.0551085471383028
208,91345,1930,14914,1371,351,1722,16636,0.10351045924501082,0.021098821832171193,0.08241163741283962,1.1207897793263646
209,91350,6615,39105,4266,1393,5659,44764,0.12641855062103477,0.03111875614332946,0.0952997944777053,1.168934440713907
210,91351,3837,27366,2784,876,3660,31026,0.1179655772577838,0.02823438406497776,0.08973119319280604,1.048360655737705
211,91352,3396,26049,2446,794,3240,29289,0.11062173512240091,0.02710915360715627,0.08351258151524463,1.048148148148148
212,91354,4808,31551,3971,734,4705,36256,0.1297716240070609,0.020244924977934686,0.10952669902912622,1.0218916046758768
213,91355,3367,27594,2929,413,3342,30936,0.10802948021722265,0.01335014222911818,0.09467933798810448,1.0074805505685218
214,91356,3765,20588,2644,980,3624,24212,0.14967784569634893,0.040475797125392364,0.10920204857095656,1.038907284768212
215,91360,4565,41013,3750,787,4537,45550,0.09960482985729967,0.017277716794731064,0.08232711306256861,1.0061714789508487
216,91361,3063,20710,2327,691,3018,23728,0.12719150370869858,0.02912171274443695,0.09806979096426163,1.014910536779324
217,91362,4768,33549,3626,1112,4738,38287,0.1237495755739546,0.02904380076788466,0.09470577480606994,1.006331785563529
218,91364,5173,29382,3805,1216,5021,34403,0.14594657442664885,0.03534575473069209,0.11060081969595675,1.0302728540131447
219,91367,4758,31172,3900,775,4675,35847,0.13041537646107065,0.02161966133846626,0.1087957151226044,1.0177540106951872
220,91377,1769,12934,1305,440,1745,14679,0.11887730771850943,0.029974793923291776,0.08890251379521766,1.0137535816618912
221,91381,2546,15364,1884,561,2445,17809,0.13729013420180808,0.03150092649783817,0.1057892077039699,1.0413087934560328
222,91384,3379,21200,2316,1177,3493,24693,0.14145709310330862,0.047665330255538006,0.09379176284777062,0.9673632980246206
223,91387,4949,26316,3091,1277,4368,30684,0.14235432147047322,0.04161778125407378,0.10073654021639943,1.1330128205128205
224,91390,3044,18096,2046,978,3024,21120,0.1431818181818182,0.046306818181818185,0.096875,1.0066137566137565
225,91401,3108,21251,2511,510,3021,24272,0.12446440342781806,0.021011865524060647,0.10345253790375741,1.028798411122145
226,91402,2771,20844,2015,584,2599,23443,0.1108646504286994,0.02491148743761464,0.08595316299108476,1.0661792997306656
227,91403,2549,16071,1992,566,2558,18629,0.1373127918836223,0.03038273659348328,0.10693005529013903,0.9964816262705238
228,91405,2749,17282,2121,495,2616,19898,0.13147049954769324,0.024876872047441954,0.10659362750025128,1.0508409785932722
229,91406,4190,30778,3323,608,3931,34709,0.11325592785732808,0.01751707050044657,0.09573885735688151,1.065886542864411
230,91411,1270,9512,1017,196,1213,10725,0.1131002331002331,0.018275058275058275,0.09482517482517483,1.0469909315746084
231,91423,2778,19965,2190,572,2762,22727,0.12152945835350024,0.025168302019624236,0.096361156333876,1.005792903692976
232,91436,2767,17561,2017,700,2717,20278,0.1339875727389289,0.034520169641976524,0.09946740309695236,1.0184026499815972
233,91501,1298,10357,973,232,1205,11562,0.10422072305829441,0.02006573257221934,0.08415499048607507,1.0771784232365145
234,91502,190,1809,165,31,196,2005,0.09775561097256857,0.015461346633416459,0.08229426433915212,0.9693877551020408
235,91504,2183,18641,1643,412,2055,20696,0.0992945496714341,0.019907228449942017,0.07938732122149207,1.062287104622871
236,91505,2831,29778,2402,346,2748,32526,0.08448625714812766,0.01063764373116891,0.07384861341695874,1.0302037845705967
237,91506,1887,19208,1559,241,1800,21008,0.08568164508758568,0.011471820258948972,0.07420982482863671,1.0483333333333333
238,91601,1976,14180,1575,312,1887,16067,0.11744569614738283,0.01941868425966266,0.09802701188772017,1.0471648118706942
239,91602,1338,9368,1086,212,1298,10666,0.1216951059441215,0.01987624226514157,0.10181886367897994,1.0308166409861326
240,91604,3244,21770,2450,782,3232,25002,0.12926965842732582,0.03127749780017599,0.09799216062714983,1.0037128712871286
241,91605,3586,25334,2636,802,3438,28772,0.11949117197275129,0.02787432225775059,0.0916168497150007,1.0430482838859803
242,91606,2751,20624,2043,518,2561,23185,0.11045934871684279,0.022342031485874488,0.0881173172309683,1.0741897696212417
243,91607,2175,15100,1714,299,2013,17113,0.11762987202711389,0.0174720972360194,0.10015777479109449,1.0804769001490313
244,91701,5496,42309,4494,861,5355,47664,0.11234894259818731,0.018063947633434038,0.09428499496475327,1.026330532212885
245,91702,4182,36752,3178,703,3881,40633,0.09551349888022051,0.017301208377427213,0.0782122905027933,1.0775573305849009
246,91706,5085,44491,3742,957,4699,49190,0.09552754624923765,0.019455173815816223,0.07607237243342142,1.0821451372632476
247,91708,2678,7165,1486,163,1649,8814,0.18708872248695257,0.018493306103925574,0.168595416383027,1.6240145542753184
248,91709,11483,72165,8427,2697,11124,83289,0.13355905341641752,0.03238122681266434,0.1011778266037532,1.0322725638259618
249,91710,8844,65536,6931,1295,8226,73762,0.11152083728749221,0.01755646538868252,0.09396437189880968,1.075127644055434
250,91711,3295,32282,2693,574,3267,35549,0.09190131930574699,0.01614672705280036,0.07575459225294663,1.0085705540250995
251,91722,3098,28718,2415,517,2932,31650,0.09263823064770932,0.016334913112164298,0.07630331753554502,1.0566166439290587
252,91723,1262,12368,1010,166,1176,13544,0.08682811577082103,0.0122563496751329,0.07457176609568812,1.0731292517006803
253,91724,2664,21965,2038,449,2487,24452,0.10170947161786358,0.018362506134467528,0.08334696548339604,1.0711700844390832
254,91730,5645,41224,4488,916,5404,46628,0.11589602813759972,0.019644848588830744,0.09625117954876898,1.0445965951147298
255,91731,1505,14639,1121,307,1428,16067,0.08887782411153296,0.019107487396527043,0.06977033671500592,1.053921568627451
256,91732,3862,32031,2790,760,3550,35581,0.0997723504117366,0.02135971445434361,0.07841263595739299,1.087887323943662
257,91733,2332,21088,1725,514,2239,23327,0.09598319543876195,0.022034552235606807,0.07394864320315514,1.0415364001786511
258,91737,3517,23630,2726,713,3439,27069,0.12704569803095792,0.02634009383427537,0.10070560419668255,1.0226810119220704
259,91739,5722,33662,4617,958,5575,39237,0.14208527665213957,0.024415730050717434,0.11766954660142212,1.0263677130044844
260,91740,2428,22373,1949,401,2350,24723,0.09505318933786353,0.01621971443595033,0.0788334749019132,1.033191489361702
261,91741,3159,28752,2408,538,2946,31698,0.09293961764149157,0.016972679664332135,0.07596693797715945,1.0723014256619146
262,91743,0,22,3,0,3,25,0.12,0.0,0.12,0.0
263,91744,6413,51410,4691,1408,6099,57509,0.10605296562277208,0.024483124380531743,0.08156984124224034,1.0514838498114445
264,91745,5598,48802,4336,1163,5499,54301,0.10126885324395499,0.021417653450212702,0.07985119979374229,1.0180032733224222
265,91746,2360,20155,1781,542,2323,22478,0.10334549337129638,0.024112465521843582,0.0792330278494528,1.0159276797244943
266,91748,5027,35651,3775,1048,4823,40474,0.11916291940505015,0.025893165983100264,0.09326975342194989,1.0422973253161933
267,91750,4164,35770,3296,751,4047,39817,0.10164000301378807,0.018861290403596454,0.08277871261019162,1.028910303928836
268,91752,5144,26498,3562,874,4436,30934,0.14340208185168424,0.028253701428848515,0.11514838042283572,1.1596032461677186
269,91754,2610,27695,2065,530,2595,30290,0.08567183889072301,0.017497523935292175,0.06817431495543083,1.0057803468208093
270,91755,1826,18584,1449,321,1770,20354,0.0869607939471357,0.015770855851429694,0.071189938095706,1.031638418079096
271,91759,78,709,47,35,82,791,0.10366624525916561,0.04424778761061947,0.05941845764854614,0.9512195121951219
272,91761,7429,44153,4697,1017,5714,49867,0.11458479555617944,0.020394248701546113,0.09419054685463332,1.30014000700035
273,91762,7095,39239,4321,1008,5329,44568,0.11957009513552325,0.022617124394184167,0.09695297074133907,1.3313942578344906
274,91763,2939,23344,2233,537,2770,26114,0.10607337060580531,0.02056368231599908,0.08550968828980623,1.0610108303249097
275,91764,4351,31300,3181,948,4129,35429,0.11654294504501962,0.026757740833780238,0.08978520421123938,1.053766045047227
276,91765,6067,41308,4540,1547,6087,47395,0.12843126912121533,0.03264057390020044,0.09579069522101487,0.9967143091835058
277,91766,5702,42229,4048,1217,5265,47494,0.11085610813997558,0.02562428938392218,0.0852318187560534,1.0830009496676163
278,91767,4171,32054,3070,836,3906,35960,0.10862068965517241,0.02324805339265851,0.0853726362625139,1.0678443420378905
279,91768,2526,18770,1794,522,2316,21086,0.10983591008251921,0.024755762117044486,0.08508014796547472,1.0906735751295338
280,91770,4468,46029,3358,968,4326,50355,0.08591003872505212,0.01922351305729322,0.06668652566775891,1.0328247803975958
281,91773,3756,30792,2923,690,3613,34405,0.10501380613282953,0.02005522453131812,0.0849585816015114,1.0395792969831166
282,91775,2397,24415,1999,357,2356,26771,0.0880056777856636,0.01333532553882933,0.07467035224683426,1.017402376910017
283,91776,2396,22757,1865,436,2301,25058,0.0918269614494373,0.01739963285178386,0.07442732859765344,1.0412863972186006
284,91780,3774,33410,3057,477,3534,36944,0.09565829363360762,0.012911433521004764,0.08274686011260286,1.067911714770798
285,91784,4215,32093,3309,543,3852,35945,0.10716372235359577,0.015106412574767004,0.09205730977882877,1.0942367601246106
286,91786,4650,34796,3503,683,4186,38982,0.10738289466933457,0.01752090708532143,0.08986198758401313,1.1108456760630674
287,91789,5503,42675,4314,1053,5367,48042,0.11171474959410516,0.021918321468714873,0.08979642812539028,1.0253400409912428
288,91790,3812,35877,3001,673,3674,39551,0.0928927207908776,0.01701600465222118,0.07587671613865642,1.0375612411540556
289,91791,3198,26586,2584,551,3135,29721,0.10548097304935904,0.01853908011170553,0.08694189293765352,1.0200956937799044
290,91792,2244,19544,1836,369,2205,21749,0.10138397167685871,0.016966297301025335,0.08441767437583338,1.017687074829932
291,91801,2674,29107,2200,477,2677,31784,0.08422476717845456,0.015007550969041028,0.06921721620941354,0.9988793425476279
292,91803,2201,23971,1718,366,2084,26055,0.07998464786029554,0.014047207829591249,0.06593744003070429,1.0561420345489443
293,91901,2969,15910,1679,1478,3157,19067,0.16557402842607646,0.07751612734043112,0.08805790108564536,0.9404497941083307
294,91902,2325,18308,1829,526,2355,20663,0.11397183371243286,0.02545612931326526,0.08851570439916759,0.9872611464968153
295,91905,224,1492,144,117,261,1753,0.1488876212207644,0.06674272675413577,0.08214489446662863,0.8582375478927203
296,91906,608,3122,425,298,723,3845,0.18803641092327697,0.07750325097529259,0.11053315994798439,0.8409405255878285
297,91910,5840,51230,4848,1166,6014,57244,0.10505904548948361,0.020368946963873945,0.08469009852560967,0.9710675091453276
298,91911,5969,50935,4876,1306,6182,57117,0.10823397587408302,0.02286534656932262,0.0853686293047604,0.9655451310255581
299,91912,1,42,3,2,5,47,0.10638297872340426,0.0425531914893617,0.06382978723404255,0.2
300,91913,6137,37690,4342,749,5091,42781,0.11900142586662303,0.017507772141838667,0.10149365372478436,1.2054606167747004
301,91914,2168,15015,1728,510,2238,17253,0.12971657103112502,0.029560076508433317,0.10015649452269171,0.968722073279714
302,91915,3148,21989,2773,426,3199,25188,0.12700492297919644,0.016912815626488803,0.11009210735270764,0.984057517974367
303,91916,290,1812,175,119,294,2106,0.1396011396011396,0.056505223171889836,0.08309591642924977,0.9863945578231292
304,91917,76,443,46,29,75,518,0.14478764478764478,0.055984555984555984,0.0888030888030888,1.0133333333333334
305,91931,47,241,22,42,64,305,0.2098360655737705,0.1377049180327869,0.07213114754098361,0.734375
306,91932,2080,17244,1847,352,2199,19443,0.11309983027310601,0.01810420202643625,0.09499562824666975,0.9458844929513415
307,91934,130,716,96,54,150,866,0.17321016166281755,0.06235565819861432,0.11085450346420324,0.8666666666666667
308,91935,1590,8660,875,883,1758,10418,0.16874640046074102,0.08475715108466117,0.08398924937607986,0.9044368600682594
309,91941,4125,35453,3600,712,4312,39765,0.10843706777316736,0.01790519300892745,0.0905318747642399,0.9566326530612245
310,91942,3200,26841,2678,444,3122,29963,0.10419517404799253,0.014818275873577412,0.08937689817441512,1.0249839846252402
311,91945,3017,23156,2403,600,3003,26159,0.1147979662831148,0.022936656600022937,0.09186130968309186,1.0046620046620047
312,91948,39,404,39,14,53,457,0.11597374179431072,0.030634573304157548,0.08533916849015317,0.7358490566037735
313,91950,3444,28501,2613,947,3560,32061,0.11103833317738061,0.02953744424690434,0.08150088893047627,0.9674157303370786
314,91962,363,2369,211,142,353,2722,0.12968405584129317,0.05216752387950037,0.0775165319617928,1.028328611898017
315,91963,93,464,53,51,104,568,0.18309859154929578,0.0897887323943662,0.09330985915492958,0.8942307692307693
316,91977,6440,46380,5135,1602,6737,53117,0.12683321723741928,0.030159835834102075,0.0966733814033172,0.9559150957399436
317,91978,1354,7394,822,353,1175,8569,0.13712218461897538,0.04119500525148792,0.09592717936748746,1.152340425531915
318,91980,3,99,10,3,13,112,0.11607142857142858,0.026785714285714284,0.08928571428571429,0.23076923076923078
319,92003,957,4623,599,281,880,5503,0.15991277485008176,0.051063056514628384,0.10884971833545339,1.0875
320,92004,1149,6447,869,228,1097,7544,0.1454135737009544,0.030222693531283137,0.11519088016967126,1.0474020054694622
321,92007,1515,12136,1293,241,1534,13670,0.11221653255303585,0.017629846378931967,0.09458668617410387,0.9876140808344198
322,92008,3009,24294,2615,546,3161,27455,0.11513385539974504,0.019887087962119833,0.09524676743762521,0.9519139512812401
323,92009,5816,43345,5012,1176,6188,49533,0.12492681646579049,0.02374174792562534,0.10118506854016514,0.9398836457659987
324,92010,2589,16142,1906,439,2345,18487,0.12684589170768648,0.023746416400714017,0.10309947530697247,1.1040511727078892
325,92011,3369,23339,2749,446,3195,26534,0.12041154744855657,0.016808622898922137,0.10360292454963443,1.0544600938967137
326,92014,1920,16281,1596,422,2018,18299,0.11027925023225313,0.023061369473741735,0.08721788075851139,0.9514370664023786
327,92019,5553,36497,4134,1449,5583,42080,0.132675855513308,0.03443441064638783,0.09824144486692016,0.9946265448683503
328,92020,4553,35744,3747,874,4621,40365,0.1144803666542797,0.021652421652421653,0.09282794500185805,0.9852845704392988
329,92021,6883,44030,4959,1681,6640,50670,0.13104401026248272,0.0331754489836195,0.09786856127886323,1.0365963855421687
330,92022,0,23,0,0,0,23,0.0,0.0,0.0,
331,92024,6505,52939,5269,1207,6476,59415,0.10899604476983926,0.020314735336194562,0.0886813094336447,1.0044780728844966
332,92025,4139,28697,3133,1035,4168,32865,0.12682184694964246,0.0314924691921497,0.09532937775749277,0.9930422264875239
333,92026,7449,43154,5109,2140,7249,50403,0.14382080431720334,0.04245779021090015,0.10136301410630319,1.0275900124155055
334,92027,6462,41486,4638,1765,6403,47889,0.1337050262064357,0.036856062978972204,0.0968489632274635,1.0092144307355926
335,92028,9528,47511,6062,2806,8868,56379,0.15729260895014102,0.049770304546018905,0.1075223044041221,1.0744248985115021
336,92029,3957,22032,2435,1088,3523,25555,0.1378595186851888,0.04257483858344747,0.09528468010174135,1.1231904626738576
337,92036,888,5378,593,407,1000,6378,0.15678896205707119,0.06381310755722797,0.0929758544998432,0.888
338,92037,4572,36901,3826,903,4729,41630,0.11359596444871486,0.02169108815757867,0.0919048762911362,0.9668005920913513
339,92040,5450,37717,3861,1552,5413,43130,0.12550428935775562,0.03598423371203339,0.08952005564572224,1.006835396268243
340,92054,3650,30139,3098,684,3782,33921,0.1114943545296424,0.020164499867338818,0.09132985466230359,0.965097831835008
341,92055,0,49,2,7,9,58,0.15517241379310345,0.1206896551724138,0.034482758620689655,0.0
342,92056,7715,56553,6515,1336,7851,64404,0.12190236631265139,0.02074405316439973,0.10115831314825166,0.9826773659406445
343,92057,7698,52204,6315,1408,7723,59927,0.12887346271296746,0.02349525255727802,0.10537821015568942,0.9967629159652984
344,92058,2450,14388,1813,481,2294,16682,0.1375134875914159,0.02883347320465172,0.10868001438676418,1.0680034873583262
345,92059,80,350,51,41,92,442,0.2081447963800905,0.09276018099547512,0.11538461538461539,0.8695652173913043
346,92060,62,520,100,44,144,664,0.21686746987951808,0.06626506024096386,0.15060240963855423,0.4305555555555556
347,92061,440,1944,322,178,500,2444,0.20458265139116202,0.07283142389525368,0.13175122749590834,0.88
348,92064,6184,47806,4729,1505,6234,54040,0.11535899333826795,0.027849740932642485,0.08750925240562546,0.9919794674366378
349,92065,7103,33827,4086,3194,7280,41107,0.1770987909601771,0.0776996618580777,0.0993991291020994,0.9756868131868132
350,92066,85,419,47,36,83,502,0.16533864541832669,0.07171314741035857,0.09362549800796813,1.0240963855421688
351,92067,2280,11460,1475,684,2159,13619,0.1585285263235186,0.05022395183199941,0.1083045744915192,1.0560444650301066
352,92069,4932,36572,4041,1387,5428,42000,0.12923809523809524,0.033023809523809525,0.09621428571428571,0.9086219602063376
353,92070,143,823,119,91,210,1033,0.20329138431752178,0.08809293320425944,0.11519845111326234,0.680952380952381
354,92071,6886,49677,4931,1220,6151,55828,0.11017768861503188,0.021852833703517947,0.08832485491151394,1.1194927654039994
355,92075,1334,11262,1134,286,1420,12682,0.111969720864217,0.022551648005046523,0.08941807285917047,0.9394366197183098
356,92078,7348,41963,5466,1529,6995,48958,0.14287756852812614,0.031230850933453163,0.11164671759467298,1.0504646175839885
357,92081,3615,22845,2736,559,3295,26140,0.1260520275439939,0.02138485080336649,0.1046671767406274,1.0971168437025796
358,92082,3605,18068,2110,1521,3631,21699,0.16733490022581685,0.07009539610120281,0.09723950412461403,0.9928394381713027
359,92083,3125,23896,2568,667,3235,27131,0.11923629796174118,0.02458442372194169,0.0946518742397995,0.9659969088098919
360,92084,5463,37104,3811,1550,5361,42465,0.12624514305898976,0.0365006475921347,0.08974449546685506,1.0190263010632346
361,92086,345,1371,239,316,555,1926,0.2881619937694704,0.1640706126687435,0.1240913811007269,0.6216216216216216
362,92091,651,2854,467,151,618,3472,0.17799539170506912,0.04349078341013825,0.13450460829493088,1.0533980582524272
363,92096,1,38,2,18,20,58,0.3448275862068966,0.3103448275862069,0.034482758620689655,0.05
364,92101,812,7153,1219,124,1343,8496,0.1580743879472693,0.014595103578154425,0.1434792843691149,0.6046165301563663
365,92102,3113,23651,2443,656,3099,26750,0.11585046728971962,0.02452336448598131,0.09132710280373832,1.0045175863181672
366,92103,2645,22319,2314,447,2761,25080,0.11008771929824561,0.017822966507177032,0.09226475279106858,0.9579862368706991
367,92104,3804,31652,3378,577,3955,35607,0.11107366529053277,0.016204678855281266,0.09486898643525149,0.9618204804045511
368,92105,4258,35549,3342,953,4295,39844,0.10779540206806545,0.023918281297058527,0.08387712077100692,0.9913853317811409
369,92106,2271,20026,1957,353,2310,22336,0.10342048710601719,0.015804083094555874,0.08761640401146131,0.9831168831168832
370,92107,2832,25789,2419,425,2844,28633,0.09932595257220689,0.01484301330632487,0.08448293926588202,0.9957805907172996
371,92108,576,4500,651,78,729,5229,0.13941480206540446,0.01491681009753299,0.12449799196787148,0.7901234567901234
372,92109,3975,32686,3445,559,4004,36690,0.10913055328427364,0.015235759062414827,0.09389479422185881,0.9927572427572428
373,92110,1731,15692,1543,309,1852,17544,0.10556315549475605,0.017612859097127224,0.08795029639762882,0.9346652267818575
374,92111,3525,32425,2969,582,3551,35976,0.09870469201690016,0.016177451634422947,0.0825272403824772,0.9926781188397634
375,92113,3117,23003,2297,882,3179,26182,0.12141929569933542,0.03368726606065236,0.08773202963868307,0.9804970116388801
376,92114,6295,55341,4921,1679,6600,61941,0.10655301012253596,0.027106439999354224,0.07944657012318174,0.9537878787878787
377,92115,4840,38165,4171,759,4930,43095,0.11439842209072978,0.017612252001392274,0.09678617008933751,0.9817444219066938
378,92116,3036,25880,2660,467,3127,29007,0.1078015651394491,0.0160995621746475,0.0917020029648016,0.9708986248800767
379,92117,5621,52500,4756,972,5728,58228,0.09837191729065055,0.016692999931304527,0.08167891735934601,0.9813198324022346
380,92118,1899,17333,1835,292,2127,19460,0.10930113052415211,0.01500513874614594,0.09429599177800617,0.8928067700987306
381,92119,2775,24952,2301,552,2853,27805,0.10260744470418989,0.019852544506383744,0.08275490019780615,0.9726603575184016
382,92120,3703,32267,3158,688,3846,36113,0.10649904466535597,0.019051311162185364,0.0874477335031706,0.9628185127405097
383,92121,397,2824,302,144,446,3270,0.1363914373088685,0.044036697247706424,0.09235474006116208,0.8901345291479821
384,92122,2081,20972,1781,387,2168,23140,0.09369057908383752,0.01672428694900605,0.07696629213483146,0.959870848708487
385,92123,2116,19386,1831,349,2180,21566,0.10108504126866363,0.01618288045998331,0.08490216080868034,0.9706422018348624
386,92124,1993,17701,1609,582,2191,19892,0.11014478182183793,0.029257993163080635,0.08088678865875729,0.90963030579644
387,92126,6121,54503,5032,1381,6413,60916,0.1052761179328912,0.02267056274213671,0.08260555519075448,0.9544674879151723
388,92127,7041,40911,5360,1467,6827,47738,0.1430097616154845,0.030730235870794754,0.11227952574468976,1.0313461256774572
389,92128,5793,41888,4751,1266,6017,47905,0.12560275545350172,0.02642730403924434,0.09917545141425739,0.9627721455875021
390,92129,6263,48034,4724,1811,6535,54569,0.11975663838443072,0.03318734079788891,0.0865692975865418,0.9583779648048967
391,92130,7877,47084,5997,1566,7563,54647,0.13839735026625433,0.02865665086830018,0.10974069939795414,1.0415179161708317
392,92131,5020,32885,3354,2016,5370,38255,0.14037380734544505,0.052698993595608416,0.08767481374983663,0.9348230912476723
393,92134,3,10,1,0,1,11,0.09090909090909091,0.0,0.09090909090909091,3.0
394,92139,2638,23987,2114,641,2755,26742,0.10302146436317404,0.023969785356368258,0.07905167900680578,0.9575317604355716
395,92140,1,55,4,2,6,61,0.09836065573770492,0.03278688524590164,0.06557377049180328,0.16666666666666666
396,92154,5689,48460,4437,1416,5853,54313,0.10776425533481855,0.026071106364958664,0.08169314896985988,0.9719801811037075
397,92173,1001,9178,829,294,1123,10301,0.10901854188913698,0.028540918357441027,0.08047762353169595,0.8913624220837043
398,92201,9454,51856,6978,1565,8543,60399,0.14144273911819732,0.02591102501697048,0.11553171410122684,1.106637012758984
399,92202,0,35,2,1,3,38,0.07894736842105263,0.02631578947368421,0.05263157894736842,0.0
400,92203,8296,40141,6361,891,7252,47393,0.15301837824151246,0.018800244761884667,0.1342181334796278,1.1439602868174297
401,92210,1937,10413,1562,280,1842,12255,0.1503059975520196,0.02284781721746226,0.12745818033455733,1.0515743756786102
402,92211,7020,38496,6247,708,6955,45451,0.15302193571098546,0.015577215022771776,0.13744472068821367,1.0093457943925233
403,92220,6410,32903,4291,1566,5857,38760,0.151109391124871,0.040402476780185756,0.11070691434468524,1.0944169369984633
404,92223,12174,61241,8228,2203,10431,71672,0.14553800647393683,0.03073724746065409,0.11480075901328274,1.167098073051481
405,92225,2224,16230,1549,510,2059,18289,0.11258133304171906,0.027885614303679807,0.08469571873803926,1.0801359883438562
406,92226,0,10,1,0,1,11,0.09090909090909091,0.0,0.09090909090909091,0.0
407,92227,2312,19049,1553,575,2128,21177,0.10048637672947065,0.027152098975303397,0.07333427775416726,1.086466165413534
408,92230,402,1883,264,161,425,2308,0.1841421143847487,0.06975736568457538,0.11438474870017332,0.9458823529411765
409,92231,2747,23953,2023,866,2889,26842,0.10762983384248566,0.03226287161910439,0.07536696222338127,0.9508480443059882
410,92233,260,2434,208,94,302,2736,0.11038011695906433,0.03435672514619883,0.07602339181286549,0.8609271523178808
411,92234,9754,48626,7003,1587,8590,57216,0.15013282997762864,0.0277369966442953,0.12239583333333333,1.1355064027939465
412,92235,0,47,9,4,13,60,0.21666666666666667,0.06666666666666667,0.15,0.0
413,92236,3691,24443,2530,882,3412,27855,0.12249147370310537,0.031663974151857836,0.09082749955124753,1.081770222743259
414,92239,86,523,67,18,85,608,0.13980263157894737,0.029605263157894735,0.11019736842105263,1.011764705882353
415,92240,7706,34688,5466,1580,7046,41734,0.16883116883116883,0.037858820146643025,0.1309723486845258,1.0936701674709055
416,92241,3151,11795,1827,577,2404,14199,0.1693076977251919,0.04063666455384182,0.1286710331713501,1.3107321131447587
417,92242,727,4329,454,139,593,4922,0.12047947988622511,0.028240552620885817,0.09223892726533929,1.2259696458684655
418,92243,4417,32016,3107,1212,4319,36335,0.11886610705930921,0.033356268061098114,0.08550983899821109,1.0226904376012966
419,92249,538,4738,455,150,605,5343,0.11323226651693805,0.02807411566535654,0.0851581508515815,0.8892561983471075
420,92250,631,5695,489,194,683,6378,0.10708686108497961,0.03041705863907181,0.0766698024459078,0.9238653001464129
421,92251,3187,19671,2070,592,2662,22333,0.11919580889267004,0.026507858326243677,0.09268795056642637,1.1972201352366643
422,92252,2726,13223,1991,525,2516,15739,0.1598576783785501,0.03335663002732067,0.12650104835122944,1.0834658187599364
423,92253,11516,58296,9578,1453,11031,69327,0.15911549612705006,0.020958645260865175,0.1381568508661849,1.0439670020850331
424,92254,666,4719,379,227,606,5325,0.11380281690140845,0.04262910798122066,0.07117370892018779,1.099009900990099
425,92256,971,5081,624,257,881,5962,0.1477692049647769,0.043106340154310634,0.10466286481046629,1.1021566401816119
426,92257,269,1845,191,43,234,2079,0.11255411255411256,0.02068302068302068,0.09187109187109187,1.1495726495726495
427,92258,130,363,74,41,115,478,0.2405857740585774,0.08577405857740586,0.15481171548117154,1.1304347826086956
428,92259,59,561,47,13,60,621,0.0966183574879227,0.020933977455716585,0.07568438003220612,0.9833333333333333
429,92260,7924,35421,5204,969,6173,41594,0.14841082848487763,0.023296629321536762,0.12511419916334088,1.2836546249797505
430,92262,6787,29703,5537,893,6430,36133,0.17795367115932803,0.024714250131458778,0.15323942102786925,1.05552099533437
431,92264,4801,21937,3691,642,4333,26270,0.16494099733536352,0.024438523030072327,0.1405024743052912,1.10800830833141
432,92266,69,547,47,16,63,610,0.10327868852459017,0.02622950819672131,0.07704918032786885,1.0952380952380953
433,92267,274,1287,120,38,158,1445,0.10934256055363321,0.02629757785467128,0.08304498269896193,1.7341772151898733
434,92268,199,1034,150,39,189,1223,0.1545380212591987,0.03188879803761243,0.12264922322158626,1.052910052910053
435,92270,5881,25590,4292,671,4963,30553,0.16243904035610252,0.021961836808169412,0.1404772035479331,1.1849687688897843
436,92273,126,864,75,44,119,983,0.12105798575788403,0.044760935910478125,0.0762970498474059,1.0588235294117647
437,92274,1756,8156,1118,453,1571,9727,0.1615092011925568,0.046571399198108356,0.11493780199444845,1.117759388924252
438,92275,82,901,159,30,189,1090,0.17339449541284405,0.027522935779816515,0.14587155963302753,0.43386243386243384
439,92276,2844,9684,1330,508,1838,11522,0.15952091650755076,0.04408956778337094,0.11543134872417983,1.5473340587595212
440,92277,4300,20744,3267,793,4060,24804,0.16368327689082407,0.0319706498951782,0.13171262699564587,1.0591133004926108
441,92278,1,54,4,2,6,60,0.1,0.03333333333333333,0.06666666666666667,0.16666666666666666
442,92280,13,104,6,3,9,113,0.07964601769911504,0.02654867256637168,0.05309734513274336,1.4444444444444444
443,92281,141,1452,107,35,142,1594,0.0890840652446675,0.021957340025094103,0.0671267252195734,0.9929577464788732
444,92282,323,1397,219,103,322,1719,0.18731820826061663,0.05991855730075625,0.1273996509598604,1.0031055900621118
445,92283,150,756,104,65,169,925,0.1827027027027027,0.07027027027027027,0.11243243243243244,0.8875739644970414
446,92284,6636,33537,5014,1256,6270,39807,0.1575099856809104,0.03155223955585701,0.1259577461250534,1.0583732057416269
447,92285,756,3264,488,203,691,3955,0.17471554993678887,0.05132743362831858,0.1233881163084703,1.0940665701881331
448,92301,5411,26310,4057,1095,5152,31462,0.16375309897654314,0.03480389040747568,0.12894920856906744,1.0502717391304348
449,92305,178,1133,133,69,202,1335,0.15131086142322098,0.051685393258426963,0.099625468164794,0.8811881188118812
450,92307,7551,40812,5673,1503,7176,47988,0.14953738434608652,0.03132033008252063,0.1182170542635659,1.0522575250836121
451,92308,8668,47002,6564,1600,8164,55166,0.1479897038030671,0.029003371641953376,0.11898633216111373,1.061734443900049
452,92309,20,119,27,7,34,153,0.2222222222222222,0.0457516339869281,0.17647058823529413,0.5882352941176471
453,92311,4814,27284,3436,1201,4637,31921,0.14526487265436547,0.03762413458224993,0.10764073807211554,1.0381712313996119
454,92313,1549,11051,1091,348,1439,12490,0.11521216973578863,0.02786228983186549,0.08734987990392314,1.0764419735927728
455,92314,5533,23730,3557,2886,6443,30173,0.21353527988599078,0.0956484274019819,0.11788685248400889,0.8587614465311191
456,92315,5332,20755,3393,2741,6134,26889,0.22812302428502362,0.10193759529919298,0.12618542898583063,0.8692533420280404
457,92316,3029,20282,2070,947,3017,23299,0.12949053607450964,0.04064552126700717,0.08884501480750247,1.003977461054027
458,92317,121,615,81,82,163,778,0.2095115681233933,0.10539845758354756,0.10411311053984576,0.7423312883435583
459,92318,26,101,21,11,32,133,0.24060150375939848,0.08270676691729323,0.15789473684210525,0.8125
460,92320,3125,11800,1577,821,2398,14198,0.16889702775038737,0.05782504578109593,0.11107198196929145,1.3031693077564637
461,92321,203,1055,133,177,310,1365,0.2271062271062271,0.12967032967032968,0.09743589743589744,0.6548387096774193
462,92322,433,1340,216,273,489,1829,0.26735921268452706,0.14926189174412247,0.1180973209404046,0.885480572597137
463,92324,5837,38167,4013,1667,5680,43847,0.1295413597281456,0.03801856455401738,0.09152279517412822,1.0276408450704226
464,92325,3786,12450,1868,2133,4001,16451,0.24320709987234818,0.12965777156403865,0.11354932830830952,0.9462634341414646
465,92327,45,352,36,24,60,412,0.14563106796116504,0.05825242718446602,0.08737864077669903,0.75
466,92328,0,10,2,0,2,12,0.16666666666666666,0.0,0.16666666666666666,0.0
467,92329,5,28,4,4,8,36,0.2222222222222222,0.1111111111111111,0.1111111111111111,0.625
468,92332,4,15,0,0,0,15,0.0,0.0,0.0,inf
469,92333,494,2237,268,314,582,2819,0.20645619013834693,0.11138701667257893,0.095069173465768,0.8487972508591065
470,92335,7132,52362,5162,1967,7129,59491,0.11983325208855121,0.03306382478021885,0.08676942730833236,1.0004208163837844
471,92336,15544,86680,11110,2500,13610,100290,0.13570645129125536,0.02492770964203809,0.11077874164921726,1.1421013960323292
472,92337,4578,30030,3527,1200,4727,34757,0.1360013810167736,0.034525419339989066,0.10147596167678453,0.9684789507086947
473,92339,313,1656,203,136,339,1995,0.1699248120300752,0.06817042606516291,0.10175438596491228,0.9233038348082596
474,92341,477,2312,317,205,522,2834,0.18419195483415668,0.07233592095977417,0.1118560338743825,0.9137931034482759
475,92342,1820,9359,1534,253,1787,11146,0.1603265745558945,0.02269872600035887,0.13762784855553561,1.0184667039731394
476,92344,4315,20163,3026,1174,4200,24363,0.1723925624923039,0.048187825801420184,0.12420473669088372,1.0273809523809523
477,92345,13364,75035,9498,3031,12529,87564,0.1430839157644694,0.03461468183271664,0.10846923393175277,1.0666453827121078
478,92346,7213,49025,5332,1666,6998,56023,0.12491298216803813,0.029737786266354888,0.09517519590168323,1.030723063732495
479,92347,65,420,40,30,70,490,0.14285714285714285,0.061224489795918366,0.08163265306122448,0.9285714285714286
480,92352,5875,19775,3319,3258,6577,26352,0.24958257437765635,0.12363387978142076,0.1259486945962356,0.8932644062642542
481,92354,2570,16614,1797,540,2337,18951,0.12331803071078043,0.028494538546778535,0.0948234921640019,1.0997004706889175
482,92356,1171,5587,765,389,1154,6741,0.17119121792018988,0.05770657172526331,0.11348464619492657,1.01473136915078
483,92358,134,644,81,57,138,782,0.17647058823529413,0.07289002557544758,0.10358056265984655,0.9710144927536232
484,92359,1296,8049,876,310,1186,9235,0.1284244721169464,0.033567948023822416,0.09485652409312398,1.0927487352445193
485,92363,1367,7831,936,280,1216,9047,0.13440919641870233,0.03094948601746435,0.10345971040123798,1.1241776315789473
486,92365,358,2276,236,116,352,2628,0.1339421613394216,0.0441400304414003,0.0898021308980213,1.0170454545454546
487,92368,131,508,78,55,133,641,0.20748829953198128,0.08580343213728549,0.12168486739469579,0.9849624060150376
488,92369,0,10,0,4,4,14,0.2857142857142857,0.2857142857142857,0.0,0.0
489,92371,3183,15584,2083,1017,3100,18684,0.16591736244915437,0.05443159922928709,0.11148576321986726,1.0267741935483872
490,92372,1431,6490,864,486,1350,7840,0.17219387755102042,0.06198979591836735,0.11020408163265306,1.06
491,92373,4248,30800,3066,1123,4189,34989,0.11972334162165252,0.03209580153762611,0.08762754008402641,1.0140845070422535
492,92374,5620,37678,3940,1086,5026,42704,0.11769389284376171,0.02543087298613713,0.09226301985762458,1.1181854357341823
493,92376,7751,52882,5520,1907,7427,60309,0.12314911538907958,0.0316204878210549,0.09152862756802467,1.0436246128988824
494,92377,2817,18886,2070,754,2824,21710,0.13007830492860434,0.03473053892215569,0.09534776600644865,0.9975212464589235
495,92378,138,518,72,103,175,693,0.25252525252525254,0.14862914862914864,0.1038961038961039,0.7885714285714286
496,92382,2307,8923,1313,1095,2408,11331,0.21251434118789161,0.09663754302356367,0.11587679816432794,0.9580564784053156
497,92384,5,66,2,0,2,68,0.029411764705882353,0.0,0.029411764705882353,2.5
498,92385,102,364,95,52,147,511,0.2876712328767123,0.10176125244618395,0.18590998043052837,0.6938775510204082
499,92386,1661,7320,1094,900,1994,9314,0.21408632166630878,0.09662873094266695,0.11745759072364183,0.8329989969909729
500,92389,12,66,12,4,16,82,0.1951219512195122,0.04878048780487805,0.14634146341463414,0.75
501,92391,858,2746,456,480,936,3682,0.2542096686583379,0.13036393264530147,0.12384573601303639,0.9166666666666666
502,92392,10229,56436,8130,1632,9762,66198,0.14746669083658118,0.02465331278890601,0.12281337804767516,1.0478385576726081
503,92394,5991,29973,4625,929,5554,35527,0.1563318039800715,0.02614912601683227,0.13018267796323924,1.0786820309686713
504,92395,7718,36284,5697,1248,6945,43229,0.16065604108353188,0.028869508894492125,0.13178653218903977,1.1113030957523398
505,92397,1409,8584,996,539,1535,10119,0.15169483150508944,0.053266133017096554,0.09842869848799289,0.9179153094462541
506,92398,184,1253,148,73,221,1474,0.14993215739484397,0.04952510176390773,0.10040705563093623,0.832579185520362
507,92399,8772,53953,6062,2567,8629,62582,0.13788309737624238,0.04101818414240516,0.09686491323383721,1.016572024568316
508,92401,110,639,97,26,123,762,0.16141732283464566,0.03412073490813648,0.1272965879265092,0.8943089430894309
509,92404,6676,38377,4743,1784,6527,44904,0.14535453411722787,0.03972920007126314,0.10562533404596472,1.0228282518768195
510,92405,3810,21088,2691,1094,3785,24873,0.15217303903831464,0.043983435854139025,0.10818960318417561,1.0066050198150593
511,92407,8387,46143,5615,2181,7796,53939,0.1445336398524259,0.04043456497154193,0.10409907488088396,1.0758081067213956
512,92408,1243,7000,1038,371,1409,8409,0.1675585682007373,0.04411939588536092,0.12343917231537638,0.8821859474804826
513,92410,4193,22285,2681,1211,3892,26177,0.14868013905336747,0.04626198571264851,0.10241815334071895,1.0773381294964028
514,92411,2661,14386,1726,787,2513,16899,0.14870702408426534,0.046570803006095035,0.1021362210781703,1.0588937524870672
515,92501,2515,15599,1789,583,2372,17971,0.13199042902453953,0.032441155194479994,0.09954927383005954,1.0602866779089377
516,92503,11410,67872,7883,2951,10834,78706,0.13765151322643762,0.0374939648819658,0.10015754834447183,1.0531659590179065
517,92504,6686,43480,4916,1576,6492,49972,0.12991275114063877,0.03153766109021052,0.09837509005042824,1.0298829328404189
518,92505,4931,32256,3587,1227,4814,37070,0.12986242244402482,0.03309954140814675,0.09676288103587807,1.0243041130037391
519,92506,7012,50906,5416,1599,7015,57921,0.12111324044819669,0.027606567566167712,0.09350667288202898,0.9995723449750534
520,92507,5518,30125,3500,1213,4713,34838,0.1352833113267122,0.03481830185429703,0.10046500947241518,1.1708041587099511
521,92508,5540,33131,4380,1117,5497,38628,0.14230609920265092,0.028916847882365124,0.11338925132028581,1.0078224486083318
522,92509,9196,56208,6174,2505,8679,64887,0.1337556058994868,0.03860557584724213,0.09515003005224468,1.0595690747782003
523,92530,10601,46050,6501,3198,9699,55749,0.17397621481999678,0.057364257654845825,0.11661195716515095,1.0929992782761109
524,92532,5632,23203,4115,1597,5712,28915,0.1975445270620785,0.055230849040290506,0.142313678021788,0.9859943977591037
525,92536,635,3759,463,240,703,4462,0.15755266696548634,0.05378753922008068,0.10376512774540565,0.903271692745377
526,92539,540,3649,479,245,724,4373,0.16556139949691287,0.056025611708209466,0.1095357877887034,0.7458563535911602
527,92543,6372,27896,4367,1512,5879,33775,0.1740636565507032,0.04476683937823834,0.12929681717246483,1.0838577989453988
528,92544,8589,42759,5830,2649,8479,51238,0.16548264959600298,0.05169991022288146,0.11378273937312151,1.012973227974997
529,92545,10062,47197,7558,2171,9729,56926,0.17090608860626075,0.03813723079085128,0.13276885781540948,1.03422756706753
530,92548,1130,5378,769,341,1110,6488,0.17108508014796547,0.052558569667077684,0.11852651048088779,1.018018018018018
531,92549,1969,9664,1251,887,2138,11802,0.18115573631587867,0.07515675309269615,0.1059989832231825,0.9209541627689429
532,92551,4339,24114,2981,1167,4148,28262,0.14676951383483122,0.04129219446606751,0.10547731936876371,1.046046287367406
533,92553,7682,48005,5520,2159,7679,55684,0.13790316787587098,0.03877235830759285,0.09913080956827815,1.0003906758692538
534,92555,6928,36458,4870,1535,6405,42863,0.1494295779576791,0.03581177239110655,0.11361780556657257,1.081654957064793
535,92557,8301,45037,5609,2272,7881,52918,0.1489285309346536,0.04293435126044068,0.10599417967421293,1.0532927293490675
536,92561,535,2600,430,184,614,3214,0.1910392034847542,0.05724953329184816,0.13378967019290602,0.8713355048859935
537,92562,11701,58508,8936,2735,11671,70179,0.16630331010701208,0.03897177218256174,0.12733153792445034,1.0025704738240082
538,92563,14156,65262,10473,2583,13056,78318,0.1667049720370796,0.03298092392553436,0.13372404811154523,1.0842524509803921
539,92567,1560,7836,1022,489,1511,9347,0.16165614635711995,0.05231625120359474,0.1093398951535252,1.0324288550628722
540,92570,7056,34229,4089,2622,6711,40940,0.1639228138739619,0.06404494382022471,0.09987787005373717,1.0514081358962897
541,92571,7722,40419,5477,2173,7650,48069,0.15914622729825875,0.04520584992406749,0.11394037737419127,1.0094117647058825
542,92582,4091,17234,2665,676,3341,20575,0.16238153098420413,0.032855407047387604,0.12952612393681653,1.224483687518707
543,92583,5113,25618,3711,1182,4893,30511,0.16036839172757367,0.03874012651174986,0.1216282652158238,1.0449621908849376
544,92584,13650,54970,8830,2143,10973,65943,0.16640128595908588,0.03249776321975039,0.13390352273933548,1.24396245329445
545,92585,5519,23824,3639,890,4529,28353,0.15973618311995202,0.03138997636934363,0.1283462067506084,1.2185913005078384
546,92586,6788,31422,4981,1417,6398,37820,0.169169751454257,0.037466948704389214,0.1317028027498678,1.060956548921538
547,92587,4798,20439,3287,1322,4609,25048,0.18400670712232514,0.05277866496327052,0.13122804215905462,1.0410067259709264
548,92590,483,2531,373,165,538,3069,0.17530140110785272,0.053763440860215055,0.12153796024763766,0.8977695167286245
549,92591,6936,37337,5443,1222,6665,44002,0.15147038770964957,0.027771464933412118,0.12369892277623744,1.0406601650412604
550,92592,14465,79554,11741,2866,14607,94161,0.15512791920221747,0.030437229850999885,0.12469068935121759,0.9902786335318683
551,92595,6507,30961,4341,1851,6192,37153,0.16666218071219013,0.04982101041638629,0.11684117029580383,1.0508720930232558
552,92596,7079,28031,4641,1029,5670,33701,0.16824426574879084,0.030533218598854633,0.1377110471499362,1.2485008818342151
553,92602,4215,18090,2578,454,3032,21122,0.14354701259350441,0.021494176687813654,0.12205283590569074,1.3901715039577835
554,92603,2398,15924,1928,385,2313,18237,0.1268300707353183,0.02111092833251083,0.10571914240280748,1.0367488110678773
555,92604,1979,18321,1674,255,1929,20250,0.09525925925925927,0.012592592592592593,0.08266666666666667,1.0259201658890618
556,92606,1443,12248,1270,186,1456,13704,0.10624635143023935,0.013572679509632224,0.09267367192060712,0.9910714285714286
557,92610,1981,10268,1240,495,1735,12003,0.14454719653419978,0.04123969007748063,0.10330750645671916,1.1417867435158502
558,92612,996,6597,853,136,989,7586,0.1303717374110203,0.01792776166622726,0.11244397574479303,1.0070778564206269
559,92614,1368,12229,1210,158,1368,13597,0.10061042877105243,0.011620210340516291,0.08899021843053614,1.0
560,92617,462,3604,303,48,351,3955,0.08874841972187104,0.01213653603034134,0.07661188369152971,1.3162393162393162
561,92618,9436,27339,5154,766,5920,33259,0.17799693316094892,0.02303135993264981,0.1549655732282991,1.593918918918919
562,92620,8101,44772,6344,783,7127,51899,0.13732441858224628,0.015086995895874679,0.12223742268637161,1.1366633927318648
563,92624,1145,8166,996,176,1172,9338,0.12550867423431142,0.018847718997644036,0.10666095523666738,0.976962457337884
564,92625,2359,16946,1978,356,2334,19280,0.12105809128630705,0.018464730290456432,0.10259336099585062,1.0107112253641817
565,92626,3839,33117,3171,558,3729,36846,0.1012050154697932,0.015144113336590131,0.08606090213320307,1.0294985250737463
566,92627,4478,35400,3478,659,4137,39537,0.10463616359359587,0.01666793130485368,0.08796823228874219,1.0824268793811942
567,92629,3568,26707,2926,509,3435,30142,0.1139605865569637,0.01688673611571893,0.09707385044124478,1.0387190684133916
568,92630,7772,51608,5916,1028,6944,58552,0.11859543653504577,0.01755704331192786,0.10103839322311792,1.1192396313364055
569,92637,414,2808,380,20,400,3208,0.12468827930174564,0.006234413965087282,0.11845386533665836,1.035
570,92646,5922,57397,4777,832,5609,63006,0.08902326762530553,0.013205091578579818,0.07581817604672571,1.055803173471207
571,92647,4561,43008,3708,647,4355,47363,0.09194941198826088,0.013660452251757702,0.07828895973650318,1.0473019517795636
572,92648,4193,33711,3423,554,3977,37688,0.10552430481850987,0.014699639142432604,0.09082466567607726,1.0543122957002766
573,92649,3703,31566,2887,504,3391,34957,0.0970048917241182,0.014417713190491175,0.08258717853362703,1.0920082571512828
574,92651,4397,32870,3134,1291,4425,37295,0.11864861241453278,0.034615900254725836,0.08403271215980694,0.9936723163841807
575,92653,3430,23655,2847,520,3367,27022,0.12460217600473689,0.01924357930575087,0.105358596698986,1.0187110187110187
576,92655,839,4927,625,168,793,5720,0.13863636363636364,0.02937062937062937,0.10926573426573427,1.0580075662042876
577,92656,4288,28422,3529,860,4389,32811,0.13376611502240102,0.026210722013958732,0.10755539300844229,0.9769879243563454
578,92657,1930,11645,1428,555,1983,13628,0.14550924567067802,0.040724977986498385,0.10478426768417963,0.9732728189611699
579,92660,3891,26680,3124,633,3757,30437,0.12343529257154122,0.020797056214475803,0.10263823635706541,1.0356667553899388
580,92661,803,5685,694,110,804,6489,0.12390198797965789,0.016951764524580058,0.10695022345507782,0.9987562189054726
581,92662,614,4738,538,88,626,5364,0.11670395227442207,0.01640566741237882,0.10029828486204326,0.9808306709265175
582,92663,2772,19559,2200,397,2597,22156,0.11721429860985738,0.017918396822531144,0.09929590178732624,1.0673854447439353
583,92672,4565,31942,3491,788,4279,36221,0.11813588802076144,0.02175533530272494,0.0963805527180365,1.0668380462724936
584,92673,4807,29106,3682,919,4601,33707,0.1364998368291453,0.02726436645207227,0.10923547037707301,1.0447728754618562
585,92675,4932,30203,3560,885,4445,34648,0.12829023320249366,0.025542599861463865,0.10274763334102978,1.1095613048368953
586,92676,373,1599,193,160,353,1952,0.18084016393442623,0.08196721311475409,0.09887295081967214,1.0566572237960339
587,92677,8046,56585,6676,1401,8077,64662,0.12491107605703504,0.021666512016331074,0.10324456404070396,0.9961619413148446
588,92678,8,151,8,11,19,170,0.11176470588235295,0.06470588235294118,0.047058823529411764,0.42105263157894735
589,92679,6498,30951,4083,2572,6655,37606,0.1769664415252885,0.06839334148806042,0.1085731000372281,0.9764087152516905
590,92683,7918,62355,6118,1132,7250,69605,0.10415918396666907,0.016263199482795775,0.08789598448387329,1.0921379310344828
591,92688,4415,29336,3430,1127,4557,33893,0.13445254182279526,0.033251703891659046,0.10120083793113623,0.9688391485626509
592,92691,5582,45571,4795,807,5602,51173,0.10947179176518868,0.01577003497938366,0.09370175678580502,0.9964298464833988
593,92692,6927,48144,5845,1144,6989,55133,0.12676618359240382,0.020749823154916292,0.10601636043748754,0.9911289168693661
594,92694,6098,25708,4253,855,5108,30816,0.16575804776739356,0.027745327102803738,0.13801272066458983,1.1938136256851997
595,92701,1599,14278,1281,387,1668,15946,0.10460303524394833,0.02426940925623981,0.08033362598770852,0.9586330935251799
596,92703,3710,26619,2475,904,3379,29998,0.11264084272284819,0.03013534235615708,0.08250550036669112,1.0979579757324651
597,92704,4791,38781,3595,943,4538,43319,0.10475772755603777,0.021768738890556107,0.08298898866548166,1.0557514323490524
598,92705,4262,37034,3458,759,4217,41251,0.10222782478000533,0.018399553950207266,0.08382827082979806,1.010671093194214
599,92706,2372,20786,1906,450,2356,23142,0.10180623973727422,0.01944516463572725,0.08236107510154697,1.0067911714770799
600,92707,2947,28316,2235,699,2934,31250,0.093888,0.022368,0.07152,1.0044308111792775
601,92708,5657,50746,4681,732,5413,56159,0.09638704392884488,0.013034420128563543,0.08335262380028134,1.045076667282468
602,92780,3163,27649,2626,471,3097,30746,0.10072855005529174,0.015319065894750537,0.08540948416054121,1.0213109460768486
603,92782,2398,17006,1983,336,2319,19325,0.12,0.01738680465717982,0.10261319534282018,1.0340664079344546
604,92801,3105,24559,2358,569,2927,27486,0.10649057702102889,0.020701448009895946,0.08578912901113293,1.0608131192347112
605,92802,2140,16265,1678,421,2099,18364,0.11429971683729034,0.022925288608146372,0.09137442822914398,1.0195331110052406
606,92804,5507,42736,4352,961,5313,48049,0.11057462174030677,0.02000041624175321,0.09057420549855356,1.036514210427254
607,92805,3729,31960,2871,720,3591,35551,0.10100981688278811,0.020252594863716913,0.08075722201907119,1.0384294068504596
608,92806,2337,20108,1896,371,2267,22375,0.10131843575418994,0.01658100558659218,0.08473743016759777,1.030877812086458
609,92807,4412,35104,3502,791,4293,39397,0.10896768789501739,0.020077670888646343,0.08889001700637104,1.027719543442814
610,92808,2483,17576,1911,587,2498,20074,0.12443957357776228,0.029241805320314836,0.09519776825744744,0.9939951961569256
611,92821,3982,33808,3186,774,3960,37768,0.10485066723151874,0.0204935395043423,0.08435712772717645,1.0055555555555555
612,92823,839,5162,585,174,759,5921,0.12818780611383213,0.029386927883803413,0.09880087823002871,1.1054018445322793
613,92831,2238,20330,1879,302,2181,22511,0.0968859668606459,0.013415663453422771,0.08347030340722314,1.0261348005502062
614,92832,1546,14565,1213,288,1501,16066,0.09342711315822233,0.01792605502303,0.07550105813519233,1.0299800133244503
615,92833,4875,38534,4056,761,4817,43351,0.11111623722636156,0.017554381675163204,0.09356185555119836,1.012040689225659
616,92835,2777,23509,2324,380,2704,26213,0.10315492312974478,0.014496623812612063,0.08865829931713272,1.0269970414201184
617,92840,4527,32753,3583,720,4303,37056,0.1161215457685665,0.019430051813471502,0.09669149395509499,1.0520567046246805
618,92841,3075,21919,2370,482,2852,24771,0.11513463324048283,0.019458237455088612,0.0956763957853942,1.0781907433380085
619,92843,3010,22188,2351,500,2851,25039,0.11386237469547505,0.019968848596189942,0.09389352609928511,1.0557699052963871
620,92844,1409,10152,1108,233,1341,11493,0.11667971808927173,0.020273209779866005,0.09640650830940573,1.0507084265473527
621,92845,1587,18566,1391,206,1597,20163,0.0792044834598026,0.01021673362098894,0.06898774983881367,0.9937382592360676
622,92860,3487,23995,2690,744,3434,27429,0.12519596047978418,0.02712457617849721,0.09807138430128697,1.0154338963308096
623,92861,863,7542,728,152,880,8422,0.10448824507242935,0.018047969603419617,0.08644027546900973,0.9806818181818182
624,92865,1883,16107,1555,268,1823,17930,0.10167317345231455,0.01494701617401004,0.08672615727830452,1.0329127811300054
625,92866,1192,11423,929,216,1145,12568,0.09110439210693826,0.01718650541056652,0.07391788669637174,1.0410480349344977
626,92867,4310,37596,3521,724,4245,41841,0.10145551014555101,0.017303601730360173,0.08415190841519084,1.0153121319199059
627,92868,1123,10195,899,188,1087,11282,0.09634816521893282,0.016663712107782308,0.07968445311115051,1.03311867525299
628,92869,3664,31286,2964,681,3645,34931,0.1043485729008617,0.019495576994646588,0.0848529959062151,1.005212620027435
629,92870,4653,40919,3930,642,4572,45491,0.1005033962761865,0.014112681629333275,0.08639071464685322,1.0177165354330708
630,92878,502,2034,148,18,166,2200,0.07545454545454545,0.008181818181818182,0.06727272727272728,3.0240963855421685
631,92879,4987,32990,4008,987,4995,37985,0.13149927603001185,0.025983941029353693,0.10551533500065816,0.9983983983983984
632,92880,10686,62758,9636,1472,11108,73866,0.1503804185958357,0.019927977689329326,0.13045244090650637,0.962009362621534
633,92881,5037,28571,3817,1050,4867,33438,0.14555296369400084,0.03140139960523955,0.11415156408876129,1.034929114444216
634,92882,8231,51985,6169,1977,8146,60131,0.13547088855997738,0.03287821589529527,0.10259267266468211,1.0104345691136754
635,92883,8509,34334,5411,1999,7410,41744,0.17751054043694903,0.04788712150249137,0.12962341893445764,1.1483130904183536
636,92886,6474,51536,5150,996,6146,57682,0.10654970354703373,0.017267085052529385,0.08928261849450435,1.053368044256427
637,92887,2930,20076,2197,838,3035,23111,0.13132274674397473,0.03625978971052746,0.09506295703344728,0.9654036243822076
638,93001,3654,29296,2566,842,3408,32704,0.10420743639921722,0.025746086105675147,0.07846135029354208,1.0721830985915493
639,93003,5007,45511,4040,909,4949,50460,0.09807768529528339,0.01801426872770511,0.08006341656757827,1.0117195393008689
640,93004,3400,30155,2726,456,3182,33337,0.09544950055493896,0.013678495365509793,0.08177100518942916,1.0685103708359522
641,93009,1,83,5,16,21,104,0.20192307692307693,0.15384615384615385,0.04807692307692308,0.047619047619047616
642,93010,5172,43680,4172,789,4961,48641,0.10199214654303983,0.01622088361670196,0.08577126292633787,1.042531747631526
643,93012,4326,34202,3543,616,4159,38361,0.10841740309168166,0.01605797554808269,0.09235942754359897,1.0401538831449868
644,93013,1520,13812,1081,331,1412,15224,0.09274829217025748,0.02174198633736206,0.07100630583289542,1.0764872521246458
645,93015,2252,13870,1317,472,1789,15659,0.11424739766268599,0.03014241011558848,0.08410498754709751,1.2588038010061486
646,93016,0,70,7,121,128,198,0.6464646464646465,0.6111111111111112,0.03535353535353535,0.0
647,93021,4759,35081,3673,961,4634,39715,0.11668135465189475,0.02419740652146544,0.0924839481304293,1.02697453603798
648,93022,953,7086,597,345,942,8028,0.11733931240657698,0.042974588938714496,0.07436472346786248,1.0116772823779194
649,93023,3373,24358,2289,1084,3373,27731,0.12163282968518986,0.0390898272691212,0.08254300241606866,1.0
650,93030,3903,36190,3226,783,4009,40199,0.0997288489763427,0.019478096470061445,0.08025075250628125,0.9735594911449239
651,93031,0,38,0,1,1,39,0.02564102564102564,0.02564102564102564,0.0,0.0
652,93033,4398,41488,3342,891,4233,45721,0.09258327683121542,0.01948776273484832,0.0730955140963671,1.038979447200567
653,93035,3705,29028,3066,567,3633,32661,0.1112335813355378,0.01736015431248278,0.09387342702305503,1.0198183319570602
654,93036,3271,25387,2412,509,2921,28308,0.10318637840893034,0.01798078281757807,0.08520559559135227,1.1198219787743924
655,93040,208,1286,87,63,150,1436,0.10445682451253482,0.04387186629526462,0.060584958217270196,1.3866666666666667
656,93041,1430,12657,1195,204,1399,14056,0.09953044963005123,0.014513375071143995,0.08501707455890722,1.0221586847748392
657,93060,3319,22504,1721,938,2659,25163,0.10567102491753766,0.0372769542582363,0.06839407065930135,1.2482136141406543
658,93061,0,49,7,53,60,109,0.5504587155963303,0.48623853211009177,0.06422018348623854,0.0
659,93063,6813,53137,5269,1388,6657,59794,0.11133224069304612,0.02321303140783356,0.08811920928521257,1.0234339792699414
660,93065,9574,68494,7116,2111,9227,77721,0.11871952239420491,0.02716125628851919,0.09155826610568572,1.037607022867671
661,93066,318,2641,220,87,307,2948,0.10413839891451832,0.029511533242876527,0.07462686567164178,1.0358306188925082
662,93067,194,1296,129,32,161,1457,0.11050102951269733,0.02196293754289636,0.08853809196980096,1.204968944099379
663,93101,1757,17092,1421,358,1779,18871,0.09427163372370304,0.018970907742038048,0.07530072598166498,0.9876335019673974
664,93103,1825,14752,1302,539,1841,16593,0.11095040077140964,0.032483577412161756,0.07846682335924787,0.9913090711569799
665,93105,3069,23159,2045,953,2998,26157,0.11461559047291356,0.03643384180142983,0.07818174867148374,1.02368245496998
666,93108,1960,13302,1362,886,2248,15550,0.14456591639871383,0.05697749196141479,0.08758842443729904,0.8718861209964412
667,93109,1244,12088,1059,232,1291,13379,0.09649450631586814,0.017340608416174602,0.07915389789969354,0.9635941130906274
668,93110,1909,15122,1455,480,1935,17057,0.1134431611655039,0.02814093920384593,0.08530222196165797,0.98656330749354
669,93111,1963,18208,1358,420,1778,19986,0.08896227359151405,0.021014710297208045,0.06794756329430601,1.1040494938132734
670,93117,2418,25361,1784,473,2257,27618,0.08172206531971903,0.0171265116952712,0.06459555362444783,1.0713336287106778
671,93201,87,372,57,39,96,468,0.20512820512820512,0.08333333333333333,0.12179487179487179,0.90625
672,93202,434,3382,330,110,440,3822,0.1151229722658294,0.02878074306645735,0.08634222919937205,0.9863636363636363
673,93203,2071,11368,1306,517,1823,13191,0.1382002880752028,0.03919338943218861,0.09900689864301418,1.136039495337356
674,93204,693,5028,460,171,631,5659,0.1115037992578194,0.03021735288920304,0.08128644636861636,1.098256735340729
675,93205,597,2476,461,449,910,3386,0.2687536916715889,0.13260484347312462,0.13614884819846426,0.656043956043956
676,93206,144,1051,97,33,130,1181,0.1100762066045724,0.0279424216765453,0.0821337849280271,1.1076923076923078
677,93207,172,765,112,63,175,940,0.18617021276595744,0.06702127659574468,0.11914893617021277,0.9828571428571429
678,93208,22,536,69,33,102,638,0.15987460815047022,0.05172413793103448,0.10815047021943573,0.21568627450980393
679,93210,1590,10980,1201,257,1458,12438,0.11722141823444283,0.020662485930213862,0.09655893230422898,1.0905349794238683
680,93212,1481,9726,1048,393,1441,11167,0.12904092415151786,0.03519297931405033,0.09384794483746754,1.0277585010409438
681,93215,3689,28811,2502,897,3399,32210,0.1055262340887923,0.027848494256442098,0.0776777398323502,1.0853192115328039
682,93218,87,480,66,41,107,587,0.18228279386712096,0.06984667802385008,0.11243611584327087,0.8130841121495327
683,93219,634,4747,409,226,635,5382,0.11798587885544408,0.041991824600520256,0.07599405425492382,0.9984251968503937
684,93221,2173,14085,1557,493,2050,16135,0.1270529903935544,0.030554694762937713,0.09649829563061667,1.06
685,93222,761,4100,560,201,761,4861,0.15655214976342316,0.041349516560378524,0.11520263320304464,1.0
686,93223,1010,7563,801,251,1052,8615,0.12211259431224608,0.02913522925130586,0.09297736506094022,0.9600760456273765
687,93224,45,549,48,40,88,637,0.13814756671899528,0.06279434850863422,0.07535321821036106,0.5113636363636364
688,93225,1288,8839,1016,431,1447,10286,0.14067664787089249,0.04190161384405989,0.09877503402683259,0.8901174844505875
689,93226,43,249,31,18,49,298,0.1644295302013423,0.06040268456375839,0.1040268456375839,0.8775510204081632
690,93227,55,947,76,27,103,1050,0.0980952380952381,0.025714285714285714,0.07238095238095238,0.5339805825242718
691,93230,8932,59717,6855,1334,8189,67906,0.12059317291550084,0.01964480311018172,0.10094836980531911,1.0907314690438392
692,93234,291,2043,191,64,255,2298,0.11096605744125326,0.0278503046127067,0.08311575282854657,1.1411764705882352
693,93235,385,3093,268,125,393,3486,0.11273666092943202,0.03585771658060815,0.07687894434882386,0.9796437659033079
694,93238,425,3131,319,115,434,3565,0.12173913043478261,0.03225806451612903,0.08948106591865358,0.9792626728110599
695,93239,74,496,52,21,73,569,0.1282952548330404,0.03690685413005272,0.0913884007029877,1.0136986301369864
696,93240,1266,7776,945,348,1293,9069,0.14257360238174,0.03837247767118756,0.10420112471055243,0.9791183294663574
697,93241,1180,7692,787,380,1167,8859,0.13173044361666103,0.04289423185461113,0.0888362117620499,1.0111396743787489
698,93242,245,1634,179,63,242,1876,0.12899786780383796,0.033582089552238806,0.09541577825159915,1.012396694214876
699,93243,200,1388,194,70,264,1652,0.15980629539951574,0.0423728813559322,0.11743341404358354,0.7575757575757576
700,93244,69,400,49,23,72,472,0.15254237288135594,0.048728813559322036,0.1038135593220339,0.9583333333333334
701,93245,3716,25959,2921,504,3425,29384,0.11656003267084128,0.017152191668935474,0.0994078410019058,1.084963503649635
702,93247,1696,11659,1107,476,1583,13242,0.11954387554750037,0.03594623168705634,0.08359764386044405,1.071383449147189
703,93249,79,757,59,28,87,844,0.10308056872037914,0.03317535545023697,0.06990521327014218,0.9080459770114943
704,93250,1121,9071,818,269,1087,10158,0.10700925379011617,0.026481590864343374,0.08052766292577279,1.031278748850046
705,93251,17,56,16,7,23,79,0.2911392405063291,0.08860759493670886,0.20253164556962025,0.7391304347826086
706,93252,212,1181,134,50,184,1365,0.1347985347985348,0.03663003663003663,0.09816849816849817,1.1521739130434783
707,93254,120,682,80,42,122,804,0.1517412935323383,0.05223880597014925,0.09950248756218906,0.9836065573770492
708,93255,102,757,80,23,103,860,0.11976744186046512,0.026744186046511628,0.09302325581395349,0.9902912621359223
709,93256,423,2646,260,143,403,3049,0.1321744834371925,0.04690062315513283,0.08527386028205969,1.0496277915632755
710,93257,8209,57829,5617,1906,7523,65352,0.11511506916391236,0.02916513649161464,0.08594993267229771,1.0911870264522132
711,93258,23,163,12,8,20,183,0.1092896174863388,0.04371584699453552,0.06557377049180328,1.15
712,93260,139,878,111,65,176,1054,0.16698292220113853,0.061669829222011384,0.10531309297912714,0.7897727272727273
713,93261,103,1144,90,37,127,1271,0.0999213217938631,0.029110936270653028,0.07081038552321008,0.8110236220472441
714,93262,1,42,18,3,21,63,0.3333333333333333,0.047619047619047616,0.2857142857142857,0.047619047619047616
715,93263,2796,15389,1624,443,2067,17456,0.11841200733272228,0.025378093492208983,0.0930339138405133,1.3526850507982584
716,93265,1044,5909,652,542,1194,7103,0.16809798676615514,0.07630578628748416,0.09179220047867098,0.8743718592964824
717,93266,131,944,102,34,136,1080,0.1259259259259259,0.03148148148148148,0.09444444444444444,0.9632352941176471
718,93267,611,3669,377,207,584,4253,0.13731483658593935,0.048671525981660003,0.08864331060427934,1.0462328767123288
719,93268,2624,14878,1812,738,2550,17428,0.14631627266467753,0.04234565067707138,0.10397062198760615,1.0290196078431373
720,93270,449,3226,301,132,433,3659,0.1183383438097841,0.036075430445476904,0.08226291336430719,1.0369515011547343
721,93271,477,3686,355,211,566,4252,0.13311382878645345,0.04962370649106303,0.0834901222953904,0.842756183745583
722,93272,244,1760,169,67,236,1996,0.11823647294589178,0.03356713426853707,0.08466933867735471,1.0338983050847457
723,93274,9483,61699,6422,1773,8195,69894,0.11724897702234813,0.02536698429049704,0.09188199273185109,1.1571690054911532
724,93275,0,44,4,1,5,49,0.10204081632653061,0.02040816326530612,0.08163265306122448,0.0
725,93276,6,79,11,4,15,94,0.1595744680851064,0.0425531914893617,0.11702127659574468,0.4
726,93277,7498,51674,5935,1457,7392,59066,0.12514813936951885,0.024667321301594825,0.10048081806792401,1.014339826839827
727,93279,1,24,3,0,3,27,0.1111111111111111,0.0,0.1111111111111111,0.3333333333333333
728,93280,1978,15947,1403,390,1793,17740,0.10107102593010146,0.021984216459977453,0.07908680947012402,1.1031790295593977
729,93283,333,2662,276,69,345,3007,0.11473229132025274,0.022946458264050548,0.09178583305620219,0.9652173913043478
730,93285,970,4558,644,800,1444,6002,0.24058647117627457,0.13328890369876709,0.1072975674775075,0.6717451523545707
731,93286,1092,6724,670,247,917,7641,0.12001046983379139,0.03232561183091218,0.0876848580028792,1.1908396946564885
732,93287,25,155,18,8,26,181,0.143646408839779,0.04419889502762431,0.09944751381215469,0.9615384615384616
733,93291,9074,53021,6483,1496,7979,61000,0.1308032786885246,0.024524590163934427,0.10627868852459016,1.137235242511593
734,93292,6677,39177,4558,1052,5610,44787,0.12525956192645188,0.0234889588496662,0.10177060307678568,1.1901960784313725
735,93301,1590,8285,1198,398,1596,9881,0.16152211314644266,0.040279323955065276,0.12124278919137739,0.9962406015037594
736,93304,6473,38568,4743,1791,6534,45102,0.14487162431821204,0.03970999068777438,0.10516163363043768,0.9906642179369453
737,93305,4641,25057,3349,1358,4707,29764,0.1581440666577073,0.045625587958607716,0.11251847869909959,0.9859783301465902
738,93306,10550,62953,7501,2196,9697,72650,0.1334755677907777,0.030227116311080524,0.10324845147969718,1.0879653501082809
739,93307,9808,55194,6517,2383,8900,64094,0.13885855150248072,0.03717976721690018,0.10167878428558055,1.1020224719101124
740,93308,8058,47332,6196,1758,7954,55286,0.14387005751908258,0.03179828528017943,0.11207177223890316,1.0130751822982147
741,93309,7259,45364,5681,1445,7126,52490,0.13575919222709087,0.02752905315298152,0.10823013907410936,1.0186640471512771
742,93311,9837,51546,6852,1183,8035,59581,0.13485842802235612,0.019855323005656164,0.11500310501669996,1.2242688238954573
743,93312,9720,66412,8237,1348,9585,75997,0.12612339960787927,0.01773754227140545,0.10838585733647381,1.0140845070422535
744,93313,9632,51297,6824,1337,8161,59458,0.1372565508426116,0.022486461031316223,0.11477008981129537,1.1802475186864354
745,93314,6087,33577,4159,663,4822,38399,0.12557618687986666,0.017266074637360348,0.10831011224250632,1.262339278307756
746,93390,0,11,0,0,0,11,0.0,0.0,0.0,
747,93401,3787,29880,2677,564,3241,33121,0.09785332568461097,0.017028471362579633,0.08082485432203133,1.1684665226781858
748,93402,2174,20462,1671,412,2083,22545,0.0923929917941894,0.018274561987136836,0.07411842980705256,1.043686989918387
749,93405,2229,17497,1585,407,1992,19489,0.10221150392529119,0.020883575350197546,0.08132792857509365,1.1189759036144578
750,93407,0,23,1,15,16,39,0.41025641025641024,0.38461538461538464,0.02564102564102564,0.0
751,93410,0,50,4,19,23,73,0.3150684931506849,0.2602739726027397,0.0547945205479452,0.0
752,93420,4187,36668,3189,708,3897,40565,0.0960680389498336,0.01745346973992358,0.07861456920991002,1.0744162176032845
753,93421,1,21,1,0,1,22,0.045454545454545456,0.0,0.045454545454545456,1.0
754,93422,4547,36720,3313,1082,4395,41115,0.10689529368843488,0.026316429526936642,0.08057886416149823,1.034584755403868
755,93423,0,35,2,8,10,45,0.2222222222222222,0.17777777777777778,0.044444444444444446,0.0
756,93424,325,1667,168,51,219,1886,0.11611876988335101,0.02704135737009544,0.08907741251325557,1.4840182648401827
757,93426,455,2542,251,139,390,2932,0.1330150068212824,0.04740791268758526,0.08560709413369713,1.1666666666666667
758,93427,680,5802,493,119,612,6414,0.09541627689429373,0.018553164951668227,0.0768631119426255,1.1111111111111112
759,93428,1611,12865,1156,400,1556,14421,0.10789820400804383,0.027737327508494558,0.08016087649954927,1.0353470437017995
760,93429,9,109,16,4,20,129,0.15503875968992248,0.031007751937984496,0.12403100775193798,0.45
761,93430,788,6393,603,139,742,7135,0.10399439383321654,0.019481429572529782,0.08451296426068676,1.0619946091644206
762,93432,197,1236,101,39,140,1376,0.10174418604651163,0.028343023255813952,0.07340116279069768,1.4071428571428573
763,93433,1691,14466,1328,210,1538,16004,0.09610097475631092,0.013121719570107474,0.08297925518620344,1.0994798439531859
764,93434,804,5591,436,114,550,6141,0.08956196059273734,0.018563751831949193,0.07099820876078815,1.461818181818182
765,93436,5650,45128,4244,1164,5408,50536,0.10701282254234605,0.02303308532531265,0.0839797372170334,1.044748520710059
766,93440,257,1761,156,67,223,1984,0.1123991935483871,0.03377016129032258,0.07862903225806452,1.1524663677130045
767,93441,174,1337,141,35,176,1513,0.1163251817580965,0.023132848645076007,0.09319233311302048,0.9886363636363636
768,93442,2068,17807,1665,334,1999,19806,0.10092901141068363,0.016863576693931133,0.0840654347167525,1.0345172586293148
769,93444,3467,25013,2605,453,3058,28071,0.10893804994478287,0.016137650956503154,0.09280039898827971,1.133747547416612
770,93445,909,7312,742,138,880,8192,0.107421875,0.016845703125,0.090576171875,1.0329545454545455
771,93446,7334,53477,5760,1181,6941,60418,0.1148829818928134,0.01954715482141084,0.09533582707140256,1.0566200835614465
772,93447,1,174,19,10,29,203,0.14285714285714285,0.04926108374384237,0.09359605911330049,0.034482758620689655
773,93449,2018,14877,1557,371,1928,16805,0.11472775959535852,0.02207676286819399,0.09265099672716454,1.0466804979253113
774,93450,49,291,56,16,72,363,0.19834710743801653,0.0440771349862259,0.15426997245179064,0.6805555555555556
775,93451,709,4257,458,123,581,4838,0.12009094667217858,0.025423728813559324,0.09466721785861927,1.2203098106712564
776,93452,18,264,17,6,23,287,0.08013937282229965,0.020905923344947737,0.059233449477351915,0.782608695652174
777,93453,405,2810,253,79,332,3142,0.10566518141311267,0.02514322087842139,0.08052196053469128,1.2198795180722892
778,93454,3409,30213,2690,709,3399,33612,0.10112459835772938,0.02109365702725217,0.08003094133047721,1.0029420417769932
779,93455,6493,50451,5116,1038,6154,56605,0.10871831110325943,0.018337602685275154,0.09038070841798428,1.0550861228469288
780,93458,4381,32100,3228,864,4092,36192,0.11306366047745359,0.023872679045092837,0.08919098143236075,1.0706256109481915
781,93460,804,6403,624,146,770,7173,0.10734699567823784,0.020354105674055486,0.08699289000418235,1.044155844155844
782,93461,221,1298,146,39,185,1483,0.12474713418745785,0.026298044504383007,0.09844908968307485,1.1945945945945946
783,93463,1286,8896,963,231,1194,10090,0.11833498513379584,0.022893954410307234,0.0954410307234886,1.0770519262981575
784,93464,0,81,4,5,9,90,0.1,0.05555555555555555,0.044444444444444446,0.0
785,93465,1615,11232,1144,235,1379,12611,0.10934898104829117,0.01863452541432083,0.09071445563397035,1.1711385061638868
786,93501,774,4122,510,211,721,4843,0.1488746644641751,0.04356803634111088,0.10530662812306421,1.073509015256588
787,93505,3046,13858,2251,581,2832,16690,0.16968244457759138,0.03481126423007789,0.13487118034751347,1.0755649717514124
788,93510,1462,8242,1011,484,1495,9737,0.15353805073431243,0.049707302043750644,0.10383074869056177,0.9779264214046822
789,93512,16,178,9,3,12,190,0.06315789473684211,0.015789473684210527,0.04736842105263158,1.3333333333333333
790,93513,268,2195,204,38,242,2437,0.09930242100943783,0.015592942141977841,0.08370947886746,1.1074380165289257
791,93514,1673,15761,1268,323,1591,17352,0.09168971876440755,0.018614568925772245,0.07307514983863532,1.0515399120050284
792,93516,427,2042,282,124,406,2448,0.16584967320261437,0.05065359477124183,0.11519607843137254,1.0517241379310345
793,93517,194,1654,118,54,172,1826,0.09419496166484119,0.029572836801752465,0.06462212486308871,1.127906976744186
794,93518,202,1570,165,78,243,1813,0.13403199117484832,0.04302261445118588,0.09100937672366244,0.831275720164609
795,93519,5,40,12,3,15,55,0.2727272727272727,0.05454545454545454,0.21818181818181817,0.3333333333333333
796,93523,214,1131,168,91,259,1390,0.18633093525179856,0.06546762589928058,0.12086330935251799,0.8262548262548263
797,93526,115,1085,88,19,107,1192,0.08976510067114093,0.015939597315436243,0.0738255033557047,1.074766355140187
798,93527,352,2918,313,93,406,3324,0.12214199759326114,0.027978339350180504,0.09416365824308062,0.8669950738916257
799,93528,17,148,14,5,19,167,0.11377245508982035,0.029940119760479042,0.08383233532934131,0.8947368421052632
800,93529,152,1653,96,55,151,1804,0.0837028824833703,0.03048780487804878,0.05321507760532151,1.0066225165562914
801,93530,7,62,8,1,9,71,0.1267605633802817,0.014084507042253521,0.11267605633802817,0.7777777777777778
802,93531,163,586,81,65,146,732,0.1994535519125683,0.08879781420765027,0.11065573770491803,1.1164383561643836
803,93532,495,2952,289,273,562,3514,0.15993170176437108,0.07768924302788845,0.08224245873648264,0.8807829181494662
804,93534,5301,29394,4147,1071,5218,34612,0.15075696290303942,0.03094302554027505,0.11981393736276436,1.0159064775776159
805,93535,11097,61124,8458,2118,10576,71700,0.14750348675034866,0.029539748953974897,0.11796373779637379,1.0492624810892588
806,93536,12300,69208,9646,2081,11727,80935,0.1448940507814913,0.025711991103972324,0.11918205967751899,1.0488616014325916
807,93541,57,592,37,26,63,655,0.09618320610687023,0.03969465648854962,0.05648854961832061,0.9047619047619048
808,93543,1953,12015,1354,583,1937,13952,0.13883314220183487,0.04178612385321101,0.09704701834862385,1.0082601961796593
809,93544,232,1350,166,63,229,1579,0.14502849905003168,0.039898670044331855,0.10512982900569981,1.0131004366812226
810,93545,281,2117,226,77,303,2420,0.12520661157024793,0.031818181818181815,0.09338842975206611,0.9273927392739274
811,93546,1515,12523,1263,295,1558,14081,0.1106455507421348,0.02095021660393438,0.08969533413820041,0.972400513478819
812,93549,29,261,21,6,27,288,0.09375,0.020833333333333332,0.07291666666666667,1.0740740740740742
813,93550,9125,55448,7237,1812,9049,64497,0.14030109927593531,0.02809432996883576,0.11220676930709955,1.0083987180903968
814,93551,10272,56766,8203,1874,10077,66843,0.15075624971949195,0.028035845189473843,0.1227204045300181,1.0193509973206312
815,93552,5473,34563,4446,911,5357,39920,0.13419338677354709,0.02282064128256513,0.11137274549098196,1.021653910770954
816,93553,330,2084,245,128,373,2457,0.15181115181115182,0.052096052096052094,0.09971509971509972,0.8847184986595175
817,93554,14,121,17,6,23,144,0.1597222222222222,0.041666666666666664,0.11805555555555555,0.6086956521739131
818,93555,5277,38241,4240,907,5147,43388,0.11862727021296211,0.020904397529270768,0.09772287268369134,1.025257431513503
819,93560,3862,19596,2733,602,3335,22931,0.14543630892678033,0.026252671056648205,0.11918363787013214,1.1580209895052473
820,93561,7882,37404,5068,2557,7625,45029,0.1693353172400009,0.056785627040351776,0.11254969019964911,1.0337049180327869
821,93562,227,1392,173,88,261,1653,0.15789473684210525,0.05323653962492438,0.10465819721718088,0.8697318007662835
822,93563,13,111,10,5,15,126,0.11904761904761904,0.03968253968253968,0.07936507936507936,0.8666666666666667
823,93591,1103,6426,807,272,1079,7505,0.14377081945369755,0.03624250499666889,0.10752831445702865,1.0222428174235403
824,93601,392,2444,250,144,394,2838,0.13883016208597604,0.0507399577167019,0.08809020436927413,0.9949238578680203
825,93602,778,3299,450,366,816,4115,0.1982989064398542,0.08894289185905224,0.10935601458080195,0.9534313725490197
826,93603,33,208,19,19,38,246,0.15447154471544716,0.07723577235772358,0.07723577235772358,0.868421052631579
827,93604,486,3035,386,154,540,3575,0.15104895104895105,0.043076923076923075,0.10797202797202797,0.9
828,93605,27,199,56,19,75,274,0.2737226277372263,0.06934306569343066,0.20437956204379562,0.36
829,93606,102,766,85,29,114,880,0.12954545454545455,0.03295454545454545,0.09659090909090909,0.8947368421052632
830,93608,83,302,31,14,45,347,0.12968299711815562,0.040345821325648415,0.0893371757925072,1.8444444444444446
831,93609,415,2871,302,107,409,3280,0.12469512195121951,0.032621951219512196,0.09207317073170732,1.0146699266503667
832,93610,2317,13200,1730,371,2101,15301,0.13731128684399713,0.024246781256127052,0.11306450558787007,1.10280818657782
833,93611,6595,52080,5733,628,6361,58441,0.10884481785048168,0.010745880460635513,0.09809893738984617,1.0367866687627731
834,93612,3609,26337,2937,520,3457,29794,0.11603007316909444,0.017453178492313887,0.09857689467678056,1.0439687590396298
835,93614,2723,15047,1809,998,2807,17854,0.15721967066203651,0.05589783801949143,0.10132183264254509,0.970074812967581
836,93615,357,2902,241,97,338,3240,0.10432098765432099,0.029938271604938272,0.07438271604938272,1.0562130177514792
837,93616,174,1265,113,44,157,1422,0.11040787623066103,0.030942334739803096,0.07946554149085795,1.10828025477707
838,93618,2943,20823,1841,699,2540,23363,0.10871891452296366,0.029919102854941575,0.07879981166802208,1.1586614173228347
839,93619,11060,53999,7110,919,8029,62028,0.12944154252918036,0.014815889598245953,0.11462565293093442,1.3775065387968615
840,93620,1144,7542,835,234,1069,8611,0.12414353733596563,0.027174544187666936,0.09696899314829868,1.0701590271281571
841,93621,48,265,26,17,43,308,0.1396103896103896,0.05519480519480519,0.08441558441558442,1.1162790697674418
842,93622,744,5108,471,153,624,5732,0.10886252616887648,0.026692254012561062,0.08217027215631542,1.1923076923076923
843,93623,59,419,52,32,84,503,0.16699801192842942,0.0636182902584493,0.10337972166998012,0.7023809523809523
844,93625,975,5852,637,146,783,6635,0.11801055011303692,0.022004521477015825,0.0960060286360211,1.2452107279693487
845,93626,604,2514,388,134,522,3036,0.17193675889328064,0.04413702239789196,0.12779973649538867,1.157088122605364
846,93628,52,613,32,22,54,667,0.08095952023988005,0.03298350824587706,0.047976011994003,0.9629629629629629
847,93630,1840,12248,1303,243,1546,13794,0.11207771494852835,0.0176163549369291,0.09446136001159924,1.1901681759379044
848,93631,2352,13970,1716,331,2047,16017,0.12780171068239995,0.020665542860710494,0.10713616782168946,1.1489985344406448
849,93633,21,258,26,21,47,305,0.1540983606557377,0.06885245901639345,0.08524590163934426,0.44680851063829785
850,93634,108,685,72,28,100,785,0.12738853503184713,0.035668789808917196,0.09171974522292993,1.08
851,93635,6676,40520,4645,758,5403,45923,0.11765346340613636,0.01650589029462361,0.10114757311151275,1.2356098463816398
852,93636,3670,14365,1768,368,2136,16501,0.12944670019998789,0.022301678686140233,0.10714502151384765,1.7181647940074907
853,93637,4819,29841,3349,716,4065,33906,0.1198902849053265,0.02111720639414853,0.09877307851117796,1.1854858548585485
854,93638,4850,33629,3606,1006,4612,38241,0.12060354070238749,0.026306843440286602,0.09429669726210088,1.051604509973981
855,93640,950,6065,605,144,749,6814,0.10992075139418843,0.021132961549750515,0.08878778984443793,1.2683578104138853
856,93641,51,496,38,25,63,559,0.11270125223613596,0.044722719141323794,0.06797853309481217,0.8095238095238095
857,93643,625,3321,323,334,657,3978,0.16515837104072398,0.08396178984414278,0.0811965811965812,0.9512937595129376
858,93644,2010,10811,1310,763,2073,12884,0.1608972368829556,0.05922073890096243,0.10167649798199317,0.9696092619392185
859,93645,41,333,20,12,32,365,0.08767123287671233,0.03287671232876712,0.0547945205479452,1.28125
860,93646,562,4936,400,174,574,5510,0.10417422867513612,0.031578947368421054,0.07259528130671507,0.9790940766550522
861,93647,771,6067,519,249,768,6835,0.11236283833211412,0.03643013899049012,0.075932699341624,1.00390625
862,93648,1060,8548,704,260,964,9512,0.10134566862910008,0.027333894028595457,0.07401177460050462,1.099585062240664
863,93650,434,3202,337,93,430,3632,0.1183920704845815,0.025605726872246697,0.0927863436123348,1.0093023255813953
864,93651,356,1770,229,115,344,2114,0.16272469252601704,0.054399243140964997,0.10832544938505204,1.0348837209302326
865,93652,17,159,53,9,62,221,0.28054298642533937,0.04072398190045249,0.2398190045248869,0.27419354838709675
866,93653,178,1087,105,58,163,1250,0.1304,0.0464,0.084,1.0920245398773005
867,93654,2704,20971,1984,577,2561,23532,0.1088305286418494,0.024519802821689612,0.08431072582015978,1.0558375634517767
868,93656,456,3391,315,95,410,3801,0.10786635096027361,0.024993422783478034,0.08287292817679558,1.1121951219512196
869,93657,3942,30457,2974,687,3661,34118,0.10730406237176857,0.020135998593118,0.08716806377865056,1.0767549849767823
870,93660,201,1872,173,45,218,2090,0.10430622009569378,0.0215311004784689,0.08277511961722488,0.9220183486238532
871,93662,2783,21756,2214,547,2761,24517,0.11261573601990456,0.022311049475873885,0.09030468654403068,1.0079681274900398
872,93664,951,4219,565,602,1167,5386,0.21667285555142962,0.1117712588191608,0.10490159673226884,0.8149100257069408
873,93665,42,335,31,10,41,376,0.10904255319148937,0.026595744680851064,0.08244680851063829,1.024390243902439
874,93666,24,92,8,6,14,106,0.1320754716981132,0.05660377358490566,0.07547169811320754,1.7142857142857142
875,93667,341,2270,237,133,370,2640,0.14015151515151514,0.05037878787878788,0.08977272727272727,0.9216216216216216
876,93668,74,681,64,15,79,760,0.10394736842105264,0.019736842105263157,0.08421052631578947,0.9367088607594937
877,93669,95,525,59,35,94,619,0.1518578352180937,0.05654281098546042,0.09531502423263329,1.0106382978723405
878,93673,61,401,40,17,57,458,0.12445414847161572,0.03711790393013101,0.08733624454148471,1.0701754385964912
879,93675,583,3960,462,212,674,4634,0.14544669831678894,0.04574881312041433,0.09969788519637462,0.8649851632047477
880,93701,846,4358,612,215,827,5185,0.15949855351976858,0.041465766634522665,0.1180327868852459,1.022974607013301
881,93702,3913,24607,2824,889,3713,28320,0.1311087570621469,0.03139124293785311,0.09971751412429379,1.0538647993536223
882,93703,3316,22012,2559,623,3182,25194,0.12629991267762167,0.024728109867428752,0.1015718028101929,1.0421118793211817
883,93704,3953,26306,3196,661,3857,30163,0.12787189603156185,0.02191426582236515,0.1059576302091967,1.024889810733731
884,93705,3851,27902,3134,607,3741,31643,0.11822519988623076,0.01918275763992036,0.0990424422463104,1.029403902699813
885,93706,2826,19208,2007,745,2752,21960,0.12531876138433515,0.033925318761384333,0.09139344262295082,1.026889534883721
886,93710,2732,21377,2306,385,2691,24068,0.11180821007146419,0.015996343692870202,0.09581186637859399,1.0152359717577109
887,93711,5189,38801,4374,719,5093,43894,0.11602952567549095,0.016380370893516197,0.09964915478197475,1.018849401138818
888,93720,6489,48526,5759,744,6503,55029,0.1181740536807865,0.013520143924112741,0.10465390975667375,0.9978471474703983
889,93721,112,674,98,21,119,793,0.15006305170239598,0.02648171500630517,0.1235813366960908,0.9411764705882353
890,93722,10753,71653,8855,1384,10239,81892,0.12503052801250428,0.016900307722366042,0.10813022029013823,1.050200214864733
891,93723,2148,9943,1359,241,1600,11543,0.13861214588928356,0.020878454474573333,0.11773369141471021,1.3425
892,93725,2162,15582,1566,427,1993,17575,0.11339971550497867,0.024295874822190613,0.08910384068278805,1.0847967887606622
893,93726,3954,27954,3292,640,3932,31886,0.12331430721946936,0.020071504735620648,0.1032428024838487,1.0055951169888098
894,93727,10204,60776,7042,1214,8256,69032,0.11959670877274307,0.01758604705064318,0.1020106617220999,1.2359496124031009
895,93728,2124,13244,1624,413,2037,15281,0.13330279431974348,0.02702702702702703,0.10627576729271644,1.0427098674521356
896,93730,2940,16315,2213,279,2492,18807,0.13250385494762587,0.014834901898229383,0.11766895304939651,1.1797752808988764
897,93737,1415,6072,821,104,925,6997,0.13219951407746178,0.014863512934114621,0.11733600114334715,1.5297297297297296
898,93740,0,30,1,1,2,32,0.0625,0.03125,0.03125,0.0
899,93778,0,21,0,0,0,21,0.0,0.0,0.0,
900,93901,2188,21799,1839,308,2147,23946,0.08966006848743005,0.012862273448592667,0.07679779503883738,1.0190964136003726
901,93905,3146,30069,2474,468,2942,33011,0.08912180788222107,0.014177092484323407,0.07494471539789767,1.0693405846363018
902,93906,4356,41737,3776,586,4362,46099,0.09462244300310202,0.012711772489641858,0.08191067051346017,0.9986244841815681
903,93907,2504,21595,1949,589,2538,24133,0.10516719844196742,0.024406414453238306,0.08076078398872913,0.9866036249014972
904,93908,1777,15218,1308,389,1697,16915,0.10032515518770323,0.022997339639373338,0.07732781554832989,1.047142015321155
905,93912,0,11,0,0,0,11,0.0,0.0,0.0,
906,93920,83,722,50,25,75,797,0.09410288582183186,0.03136762860727729,0.06273525721455459,1.1066666666666667
907,93921,723,6345,570,141,711,7056,0.10076530612244898,0.019982993197278913,0.08078231292517007,1.0168776371308017
908,93922,4,23,0,2,2,25,0.08,0.08,0.0,2.0
909,93923,2627,19644,1870,758,2628,22272,0.11799568965517242,0.03403376436781609,0.08396192528735633,0.9996194824961948
910,93924,1095,8639,766,326,1092,9731,0.11221868256088788,0.033501181790155175,0.07871750077073271,1.0027472527472527
911,93925,90,807,71,19,90,897,0.10033444816053512,0.021181716833890748,0.07915273132664437,1.0
912,93926,513,5988,426,106,532,6520,0.08159509202453988,0.01625766871165644,0.06533742331288343,0.9642857142857143
913,93927,1256,11346,881,269,1150,12496,0.09202944942381562,0.021526888604353395,0.07050256081946223,1.0921739130434782
914,93930,1350,10351,854,300,1154,11505,0.10030421555845284,0.02607561929595828,0.07422859626249456,1.169844020797227
915,93932,50,404,30,8,38,442,0.08597285067873303,0.01809954751131222,0.06787330316742081,1.3157894736842106
916,93933,2807,17364,1839,220,2059,19423,0.1060083406270916,0.011326777531792205,0.09468156309529939,1.363283147158815
917,93940,2917,28396,2357,511,2868,31264,0.09173490276356193,0.01634467758444217,0.07539022517911975,1.0170850767085076
918,93944,0,42,1,8,9,51,0.17647058823529413,0.1568627450980392,0.0196078431372549,0.0
919,93950,1940,19729,1615,253,1868,21597,0.0864934944668241,0.011714589989350373,0.07477890447747372,1.0385438972162742
920,93953,1196,8807,937,359,1296,10103,0.1282787290903692,0.035533999802039,0.0927447292883302,0.9228395061728395
921,93954,30,173,13,14,27,200,0.135,0.07,0.065,1.1111111111111112
922,93955,2396,23348,2131,327,2458,25806,0.09524916686042005,0.012671471750755638,0.08257769510966442,0.9747762408462164
923,93960,1527,12874,1085,231,1316,14190,0.0927413671599718,0.01627906976744186,0.07646229739252995,1.1603343465045592
924,93962,83,781,60,12,72,853,0.08440797186400938,0.01406799531066823,0.07033997655334115,1.1527777777777777
925,94002,2366,25249,2070,277,2347,27596,0.08504855776199449,0.010037686621249457,0.07501087114074503,1.008095440988496
926,94005,517,4400,376,95,471,4871,0.09669472387600082,0.019503182098131802,0.07719154177786902,1.0976645435244161
927,94010,4031,40745,3422,654,4076,44821,0.09093951495950559,0.014591374578880436,0.07634814038062515,0.9889597644749755
928,94014,3497,33069,2838,514,3352,36421,0.09203481507921255,0.01411273715713462,0.07792207792207792,1.043257756563246
929,94015,4373,47537,3817,470,4287,51824,0.08272229083050324,0.009069157147267675,0.07365313368323556,1.020060648472125
930,94018,358,3827,362,83,445,4272,0.10416666666666667,0.01942883895131086,0.0847378277153558,0.8044943820224719
931,94019,1873,17043,1467,268,1735,18778,0.09239535626797316,0.014272020449462136,0.07812333581851102,1.0795389048991355
932,94020,206,1900,138,79,217,2117,0.10250354274917337,0.03731695795937648,0.06518658478979689,0.9493087557603687
933,94021,27,244,17,6,23,267,0.08614232209737828,0.02247191011235955,0.06367041198501873,1.173913043478261
934,94022,2376,23135,1941,548,2489,25624,0.09713549797065252,0.02138620043709023,0.07574929753356228,0.954600241060667
935,94024,2823,28722,2443,447,2890,31612,0.09142097937492091,0.014140199924079463,0.07728077945084146,0.9768166089965398
936,94025,4042,39161,3513,503,4016,43177,0.09301248349815874,0.011649720916228548,0.08136276258193019,1.0064741035856575
937,94027,967,9066,811,177,988,10054,0.09826934553411577,0.017604933359856773,0.080664412174259,0.978744939271255
938,94028,1016,8425,673,411,1084,9509,0.11399726574823851,0.04322221053738563,0.07077505521085288,0.9372693726937269
939,94030,2137,21505,1925,204,2129,23634,0.09008208513159008,0.008631632394008631,0.08145045273758145,1.0037576326914044
940,94037,389,3765,298,53,351,4116,0.08527696793002916,0.012876579203109815,0.07240038872691934,1.1082621082621082
941,94038,375,3517,325,87,412,3929,0.10486128785950624,0.022143038941206415,0.08271824891829982,0.9101941747572816
942,94040,1835,19938,1601,203,1804,21742,0.08297304755772238,0.009336767546683838,0.07363628001103854,1.0171840354767183
943,94041,1027,9743,850,127,977,10720,0.09113805970149254,0.011847014925373133,0.07929104477611941,1.0511770726714431
944,94043,1884,14728,1489,203,1692,16420,0.10304506699147381,0.012362971985383678,0.09068209500609013,1.1134751773049645
945,94044,3455,40627,2863,480,3343,43970,0.07602911075733455,0.010916534000454855,0.06511257675687969,1.0335028417588992
946,94060,147,1149,114,44,158,1307,0.12088752869166029,0.03366488140780413,0.08722264728385616,0.930379746835443
947,94061,3040,30546,2681,336,3017,33563,0.08989065339808718,0.010011024044334535,0.07987962935375265,1.0076234670202187
948,94062,3149,32155,2605,593,3198,35353,0.090459084094702,0.016773682572907532,0.07368540152179447,0.984677923702314
949,94063,1539,14945,1310,225,1535,16480,0.09314320388349515,0.013652912621359222,0.07949029126213593,1.0026058631921824
950,94065,851,8737,776,98,874,9611,0.09093746748517324,0.010196649672250545,0.0807408178129227,0.9736842105263158
951,94066,3449,37037,2922,389,3311,40348,0.08206106870229007,0.009641122236542083,0.072419946465748,1.0416792509815767
952,94070,3175,32850,2772,379,3151,36001,0.08752534651815227,0.010527485347629232,0.07699786117052304,1.0076166296413838
953,94074,21,215,14,6,20,235,0.0851063829787234,0.02553191489361702,0.059574468085106386,1.05
954,94080,4824,52865,4170,516,4686,57551,0.081423433128877,0.008965960626227173,0.07245747250264982,1.029449423815621
955,94085,1221,9900,1000,138,1138,11038,0.10309838738901975,0.012502264903062148,0.0905961224859576,1.0729349736379614
956,94086,2721,25059,2353,320,2673,27732,0.0963868455214193,0.011539016298860522,0.08484782922255878,1.0179573512906845
957,94087,4290,47216,3983,438,4421,51637,0.08561690260859461,0.008482289830935182,0.07713461277765943,0.9703686948654151
958,94088,1,29,0,1,1,30,0.03333333333333333,0.03333333333333333,0.0,1.0
959,94089,2243,15155,1728,477,2205,17360,0.12701612903225806,0.02747695852534562,0.09953917050691244,1.017233560090703
960,94102,203,2187,260,25,285,2472,0.11529126213592233,0.010113268608414239,0.10517799352750809,0.712280701754386
961,94103,317,3373,382,60,442,3815,0.11585845347313237,0.015727391874180863,0.1001310615989515,0.7171945701357466
962,94104,5,65,43,4,47,112,0.41964285714285715,0.03571428571428571,0.38392857142857145,0.10638297872340426
963,94105,160,1245,181,23,204,1449,0.14078674948240166,0.015873015873015872,0.12491373360938578,0.7843137254901961
964,94107,986,10176,905,138,1043,11219,0.0929672876370443,0.012300561547374989,0.08066672608966931,0.9453499520613614
965,94108,74,682,85,11,96,778,0.12339331619537275,0.014138817480719794,0.10925449871465295,0.7708333333333334
966,94109,616,6242,566,111,677,6919,0.0978465096112155,0.016042780748663103,0.0818037288625524,0.9098966026587888
967,94110,3566,36317,2984,480,3464,39781,0.08707674517985974,0.012066061687740378,0.07501068349211935,1.029445727482679
968,94111,33,290,52,1,53,343,0.15451895043731778,0.0029154518950437317,0.15160349854227406,0.6226415094339622
969,94112,6313,65093,5277,847,6124,71217,0.08599070446663015,0.011893227740567561,0.0740974767260626,1.0308621815806662
970,94114,2213,24302,1917,308,2225,26527,0.08387680476495646,0.011610811625890602,0.07226599313906586,0.9946067415730337
971,94115,975,9882,858,173,1031,10913,0.09447447997800788,0.015852652799413544,0.07862182717859434,0.9456838021338506
972,94116,4309,49649,3619,573,4192,53841,0.07785888077858881,0.010642447205661112,0.0672164335729277,1.0279103053435115
973,94117,1305,14715,1106,244,1350,16065,0.08403361344537816,0.015188297541238717,0.06884531590413943,0.9666666666666667
974,94118,2006,22654,1659,324,1983,24637,0.08048869586394447,0.013150951820432683,0.0673377440435118,1.0115985879979827
975,94121,2686,31216,2310,365,2675,33891,0.07892950930925614,0.010769820896403175,0.06815968841285297,1.0041121495327103
976,94122,4237,50465,3664,544,4208,54673,0.07696669288314159,0.009950066760558228,0.06701662612258336,1.0068916349809887
977,94123,1211,11637,1017,223,1240,12877,0.09629572105304031,0.017317698221635473,0.07897802283140483,0.9766129032258064
978,94124,2375,21217,1957,366,2323,23540,0.09868309260832625,0.015548003398470688,0.08313508920985556,1.0223848471803703
979,94127,2502,26210,2207,290,2497,28707,0.08698226913296409,0.010102065698261747,0.07688020343470234,1.0020024028834602
980,94131,2519,26692,2197,330,2527,29219,0.08648482152024367,0.011294021013723947,0.07519080050651973,0.9968341907400079
981,94132,1743,17985,1496,236,1732,19717,0.08784297814069078,0.011969366536491353,0.07587361160419942,1.00635103926097
982,94133,514,5772,486,107,593,6365,0.09316575019638648,0.01681068342498036,0.07635506677140613,0.866779089376054
983,94134,2971,30963,2605,348,2953,33916,0.08706805047765066,0.010260643943861305,0.07680740653378937,1.0060954961056552
984,94143,0,37,0,1,1,38,0.02631578947368421,0.02631578947368421,0.0,0.0
985,94158,57,464,47,2,49,513,0.09551656920077972,0.003898635477582846,0.09161793372319688,1.163265306122449
986,94301,1436,16127,1247,209,1456,17583,0.08280725700961156,0.011886481260308251,0.0709207757493033,0.9862637362637363
987,94303,3572,33587,3162,507,3669,37256,0.09848078161906806,0.013608546274425596,0.08487223534464247,0.9735622785500136
988,94304,119,597,59,20,79,676,0.11686390532544379,0.029585798816568046,0.08727810650887574,1.5063291139240507
989,94305,184,2526,153,43,196,2722,0.07200587803085966,0.01579720793534166,0.056208670095518,0.9387755102040817
990,94306,2371,24436,2186,249,2435,26871,0.09061813851363924,0.009266495478396785,0.08135164303524245,0.9737166324435318
991,94401,1928,18297,1627,240,1867,20164,0.09259075580242015,0.011902400317397342,0.08068835548502282,1.032672737011248
992,94402,2317,25874,2055,279,2334,28208,0.0827424844015882,0.0098908111174135,0.0728516732841747,0.9927163667523564
993,94403,3217,34553,2832,304,3136,37689,0.08320730186526573,0.00806601395632678,0.07514128790893895,1.025829081632653
994,94404,2190,22076,1909,231,2140,24216,0.08837132474397093,0.009539147670961349,0.07883217707300957,1.0233644859813085
995,94501,4260,44246,3599,491,4090,48336,0.08461602118503807,0.010158060244952003,0.07445796094008607,1.0415647921760391
996,94502,1259,13083,1156,123,1279,14362,0.08905444924105278,0.008564266815206795,0.08049018242584598,0.9843627834245504
997,94503,2311,19526,1975,301,2276,21802,0.10439409228511146,0.01380607283735437,0.09058801944775709,1.015377855887522
998,94505,3896,20315,3063,411,3474,23789,0.14603388120559924,0.017276892681491445,0.12875698852410777,1.1214738054116293
999,94506,4673,26825,3660,901,4561,31386,0.14531956923469064,0.028707066845090168,0.11661250238960046,1.0245560184170137
1000,94507,2626,19598,1952,685,2637,22235,0.11859680683606925,0.03080728581065887,0.08778952102541039,0.9958285930982177
1001,94508,310,2722,247,98,345,3067,0.11248777306814477,0.03195304858167591,0.08053472448646887,0.8985507246376812
1002,94509,8370,62802,6928,1147,8075,70877,0.11392976565035202,0.01618296485460728,0.09774680079574474,1.036532507739938
1003,94510,2931,30346,2632,320,2952,33298,0.0886539732116043,0.009610186798005887,0.07904378641359841,0.9928861788617886
1004,94511,447,2525,292,84,376,2901,0.12961047914512236,0.028955532574974147,0.10065494657014823,1.1888297872340425
1005,94512,9,87,22,4,26,113,0.23008849557522124,0.035398230088495575,0.19469026548672566,0.34615384615384615
1006,94513,12029,73200,9378,1204,10582,83782,0.12630397937504476,0.014370628535962379,0.11193335083908237,1.1367416367416368
1007,94514,120,1776,172,48,220,1996,0.11022044088176353,0.02404809619238477,0.08617234468937876,0.5454545454545454
1008,94515,1049,7914,785,223,1008,8922,0.11297915265635508,0.02499439587536427,0.08798475678099081,1.0406746031746033
1009,94516,16,121,10,6,16,137,0.11678832116788321,0.043795620437956206,0.072992700729927,1.0
1010,94517,1777,14801,1411,275,1686,16487,0.1022623885485534,0.01667980833383878,0.08558258021471463,1.0539739027283512
1011,94518,3320,27351,2773,410,3183,30534,0.10424444881116132,0.013427654418025807,0.09081679439313552,1.0430411561420043
1012,94519,2490,21725,2216,264,2480,24205,0.10245816979962817,0.010906837430283,0.09155133236934518,1.0040322580645162
1013,94520,2633,20362,2300,364,2664,23026,0.11569530096412751,0.015808216798401806,0.0998870841657257,0.9883633633633634
1014,94521,4784,44069,4165,533,4698,48767,0.0963356368035762,0.01092952201283655,0.08540611479073965,1.0183056619838229
1015,94523,3693,33875,3306,370,3676,37551,0.09789353146387579,0.009853266224601209,0.08804026523927459,1.0046245919477692
1016,94525,473,4213,392,71,463,4676,0.09901625320786997,0.015183917878528658,0.08383233532934131,1.0215982721382288
1017,94526,4942,36927,3920,977,4897,41824,0.11708588370313695,0.023359793420045908,0.09372609028309105,1.009189299571166
1018,94528,234,1206,177,65,242,1448,0.1671270718232044,0.04488950276243094,0.12223756906077347,0.9669421487603306
1019,94530,2910,29447,2430,481,2911,32358,0.08996229680449966,0.014864948389888126,0.07509734841461153,0.9996564754379939
1020,94531,7028,44076,5503,786,6289,50365,0.1248684602402462,0.01560607564777127,0.10926238459247493,1.1175067578311337
1021,94533,8777,64044,6882,1132,8014,72058,0.11121596491715008,0.01570956729301396,0.09550639762413611,1.09520838532568
1022,94534,6232,45884,4999,774,5773,51657,0.11175639313161817,0.014983448516173994,0.09677294461544418,1.0795080547375715
1023,94536,6641,53744,5907,640,6547,60291,0.10859000514172928,0.010615183028976133,0.09797482211275314,1.0143577210936308
1024,94537,0,31,4,1,5,36,0.1388888888888889,0.027777777777777776,0.1111111111111111,0.0
1025,94538,5009,38791,4313,532,4845,43636,0.11103217526812724,0.01219176826473554,0.0988404070033917,1.0338493292053663
1026,94539,6363,50691,5470,571,6041,56732,0.10648311358668829,0.01006486638933935,0.09641824719734894,1.0533024333719583
1027,94540,0,10,1,1,2,12,0.16666666666666666,0.08333333333333333,0.08333333333333333,0.0
1028,94541,5314,42365,4285,739,5024,47389,0.10601616408871258,0.015594336238367553,0.09042182785034501,1.0577229299363058
1029,94542,2118,13739,1636,355,1991,15730,0.12657342657342657,0.02256834075015893,0.10400508582326765,1.063787041687594
1030,94544,6079,48661,4940,975,5915,54576,0.10838097332160657,0.01786499560246262,0.09051597771914395,1.0277261200338124
1031,94545,3565,28247,2983,471,3454,31701,0.10895555345257248,0.014857575470805337,0.09409797798176714,1.0321366531557614
1032,94546,4801,43823,4129,628,4757,48580,0.09792095512556608,0.012927130506381227,0.08499382461918485,1.0092495270128232
1033,94547,2657,22532,2242,310,2552,25084,0.10173815978312868,0.012358475522245256,0.08937968426088343,1.0411442006269593
1034,94548,59,460,45,10,55,515,0.10679611650485436,0.019417475728155338,0.08737864077669903,1.0727272727272728
1035,94549,4068,32837,3016,1079,4095,36932,0.11087945413191812,0.029215856168092712,0.08166359796382541,0.9934065934065934
1036,94550,5937,56622,5462,512,5974,62596,0.09543740814109528,0.008179436385711548,0.08725797175538373,0.993806494810847
1037,94551,4693,36966,3858,483,4341,41307,0.1050911467789963,0.011692933401118455,0.09339821337787785,1.0810873070721032
1038,94552,1893,15617,1377,424,1801,17418,0.10339878286829716,0.02434263405672293,0.07905614881157423,1.051082731815658
1039,94553,5796,54646,4923,774,5697,60343,0.09441028785443216,0.012826674179275143,0.08158361367515701,1.0173775671406002
1040,94555,3887,31070,3440,351,3791,34861,0.10874616333438512,0.010068557987435816,0.09867760534694932,1.0253231337378002
1041,94556,1887,16495,1436,424,1860,18355,0.10133478616180877,0.023099972759466087,0.07823481340234269,1.014516129032258
1042,94558,7628,71224,6367,1195,7562,78786,0.09598151955931257,0.015167669382885284,0.08081385017642728,1.0087278497751917
1043,94559,2868,26084,2400,369,2769,28853,0.09596922330433577,0.012788964752365439,0.08318025855197034,1.0357529794149511
1044,94560,5686,39320,4332,476,4808,44128,0.10895576504713561,0.010786802030456852,0.09816896301667875,1.18261231281198
1045,94561,7199,44808,5227,758,5985,50793,0.11783119721221429,0.014923316204988877,0.10290788100722541,1.2028404344193817
1046,94562,4,66,5,3,8,74,0.10810810810810811,0.04054054054054054,0.06756756756756757,0.5
1047,94563,3564,24106,2377,1071,3448,27554,0.12513609639253828,0.038869129708935184,0.0862669666836031,1.0336426914153132
1048,94564,2098,20334,1705,284,1989,22323,0.08910092729471845,0.012722304349773776,0.07637862294494467,1.0548014077425842
1049,94565,10531,79032,8221,1533,9754,88786,0.10985966255941251,0.01726623566778546,0.09259342689162706,1.0796596268197662
1050,94566,5771,44303,4890,722,5612,49915,0.11243113292597416,0.01446458980266453,0.09796654312330963,1.0283321454027086
1051,94567,81,527,42,24,66,593,0.11129848229342328,0.04047217537942664,0.07082630691399663,1.2272727272727273
1052,94568,8863,46646,7021,741,7762,54408,0.14266284369945595,0.013619320688134097,0.12904352301132185,1.14184488533883
1053,94569,24,312,19,2,21,333,0.06306306306306306,0.006006006006006006,0.057057057057057055,1.1428571428571428
1054,94571,3397,17161,2115,269,2384,19545,0.12197492964952673,0.013763110770017907,0.10821181887950883,1.4249161073825503
1055,94572,998,8955,832,148,980,9935,0.09864116758933066,0.014896829391041772,0.08374433819828887,1.0183673469387755
1056,94573,10,164,13,5,18,182,0.0989010989010989,0.027472527472527472,0.07142857142857142,0.5555555555555556
1057,94574,1222,9795,993,254,1247,11042,0.112932439775403,0.023003079152327476,0.08992936062307554,0.9799518845228549
1058,94576,20,222,26,5,31,253,0.1225296442687747,0.019762845849802372,0.10276679841897234,0.6451612903225806
1059,94577,4342,40911,3762,544,4306,45217,0.09522967025676184,0.012030873344096247,0.08319879691266559,1.0083604273107292
1060,94578,3013,25510,2590,370,2960,28470,0.10396909027046013,0.012996136283807516,0.09097295398665262,1.0179054054054053
1061,94579,2542,22680,2178,371,2549,25229,0.10103452376233699,0.014705299456974116,0.08632922430536287,0.9972538250294233
1062,94580,2981,28517,2608,316,2924,31441,0.09299958652714609,0.010050570910594447,0.08294901561655163,1.0194938440492476
1063,94582,6547,35533,5441,593,6034,41567,0.14516323044722979,0.014266124569971372,0.1308971058772584,1.085018230029831
1064,94583,4509,36106,3731,551,4282,40388,0.10602159057145687,0.013642666138456968,0.0923789244329999,1.0530126109294722
1065,94585,3489,30100,2988,454,3442,33542,0.10261761373800012,0.013535269214715878,0.08908234452328424,1.0136548518303312
1066,94586,168,1188,118,48,166,1354,0.12259970457902511,0.03545051698670606,0.08714918759231906,1.0120481927710843
1067,94587,6399,56552,5557,802,6359,62911,0.10107930250671583,0.012748168046923431,0.0883311344597924,1.0062902972165435
1068,94588,3501,27448,3029,360,3389,30837,0.10990044427149204,0.011674287382041055,0.09822615688945098,1.033048096783712
1069,94589,3206,28664,2644,534,3178,31842,0.09980528861252434,0.01677030337290371,0.08303498523962062,1.0088105726872247
1070,94590,4348,32842,3472,754,4226,37068,0.1140066904068199,0.020340994928239993,0.0936656954785799,1.0288689067676289
1071,94591,7005,58869,5909,866,6775,65644,0.103208214002803,0.013192370970690391,0.0900158430321126,1.0339483394833948
1072,94592,252,1186,166,17,183,1369,0.13367421475529584,0.01241782322863404,0.1212563915266618,1.3770491803278688
1073,94595,1264,10001,1073,204,1277,11278,0.11322929597446356,0.018088313530767865,0.09514098244369569,0.9898198903680501
1074,94596,1571,15767,1343,260,1603,17370,0.09228554979850316,0.014968336211859529,0.07731721358664363,0.9800374298190893
1075,94597,1718,14743,1464,214,1678,16421,0.10218622495584921,0.013032093051580294,0.08915413190426892,1.0238379022646007
1076,94598,2946,27657,2605,327,2932,30589,0.09585144986759947,0.010690117362450555,0.08516133250514892,1.004774897680764
1077,94599,417,3155,344,72,416,3571,0.1164939792775133,0.02016241949033884,0.09633155978717446,1.0024038461538463
1078,94601,3344,26318,2621,604,3225,29543,0.10916291507294452,0.02044477541211116,0.08871813966083336,1.0368992248062014
1079,94602,3275,30742,2699,533,3232,33974,0.09513157120150703,0.01568846765173368,0.07944310354977335,1.0133044554455446
1080,94603,3397,24805,2580,645,3225,28030,0.11505529789511237,0.023011059579022476,0.0920442383160899,1.0533333333333332
1081,94605,5460,40875,4171,1091,5262,46137,0.11405162884452826,0.023646964475366843,0.0904046643691614,1.0376282782212087
1082,94606,2038,16128,1594,302,1896,18024,0.1051930758988016,0.01675543719485131,0.08843763870395029,1.0748945147679325
1083,94607,1417,8102,1057,211,1268,9370,0.13532550693703307,0.022518676627534685,0.1128068303094984,1.1175078864353312
1084,94608,2497,17140,1940,391,2331,19471,0.11971650146371526,0.020081146320168455,0.09963535514354681,1.0712140712140712
1085,94609,1886,14947,1533,326,1859,16806,0.11061525645602761,0.019397834106866595,0.09121742234916101,1.0145239376008606
1086,94610,1925,19426,1634,266,1900,21326,0.08909312576198068,0.012473037606677295,0.07662008815530338,1.013157894736842
1087,94611,5117,39023,3575,1550,5125,44148,0.11608679894898977,0.03510917821871885,0.08097762073027091,0.9984390243902439
1088,94612,207,1631,182,34,216,1847,0.11694639956686519,0.018408229561451002,0.09853817000541419,0.9583333333333334
1089,94618,1923,19332,1612,294,1906,21238,0.08974479706187023,0.013843111404087014,0.07590168565778321,1.008919202518363
1090,94619,2974,26856,2383,462,2845,29701,0.09578802060536683,0.015555031817110534,0.08023298878825628,1.0453427065026362
1091,94621,2920,19927,2089,569,2658,22585,0.11768873145893292,0.025193712641133497,0.09249501881779942,1.0985703536493605
1092,94624,1,55,6,3,9,64,0.140625,0.046875,0.09375,0.1111111111111111
1093,94702,1664,16619,1387,261,1648,18267,0.09021733180051458,0.014288060436853342,0.07592927136366125,1.0097087378640777
1094,94703,1468,15378,1236,228,1464,16842,0.08692554328464552,0.013537584609903812,0.07338795867474172,1.0027322404371584
1095,94704,354,3570,271,82,353,3923,0.08998215651287281,0.020902370634718326,0.06907978587815447,1.0028328611898016
1096,94705,1340,13700,977,294,1271,14971,0.08489746843898203,0.019637966735689,0.06525950170329303,1.054287962234461
1097,94706,1437,16864,1229,186,1415,18279,0.07741123693856337,0.010175611357295257,0.06723562558126812,1.015547703180212
1098,94707,1485,18578,1180,227,1407,19985,0.07040280210157618,0.011358518889166875,0.05904428321240931,1.0554371002132197
1099,94708,1630,16705,1190,416,1606,18311,0.08770684288132817,0.02271858445742996,0.0649882584238982,1.0149439601494397
1100,94709,388,4725,299,63,362,5087,0.07116178494200905,0.012384509534106546,0.05877727540790249,1.0718232044198894
1101,94710,574,5018,476,82,558,5576,0.10007173601147776,0.014705882352941176,0.08536585365853659,1.028673835125448
1102,94801,2699,19647,2151,524,2675,22322,0.11983693217453634,0.023474599050264312,0.09636233312427202,1.0089719626168225
1103,94803,3197,27499,2614,549,3163,30662,0.10315700215250147,0.017904898571521752,0.08525210358097972,1.0107492886500158
1104,94804,4332,34557,3456,739,4195,38752,0.10825247729149463,0.019069983484723368,0.08918249380677126,1.032657926102503
1105,94805,1716,16453,1463,232,1695,18148,0.09339872162221732,0.01278377782675777,0.08061494379545955,1.0123893805309734
1106,94806,4897,43514,4073,781,4854,48368,0.1003556070129011,0.016147039364869335,0.08420856764803175,1.0088586732591678
1107,94807,3,60,5,0,5,65,0.07692307692307693,0.0,0.07692307692307693,0.6
1108,94901,3299,32613,2679,577,3256,35869,0.09077476372354959,0.016086314087373498,0.07468844963617609,1.0132063882063882
1109,94903,2645,28248,2257,401,2658,30906,0.08600271791885071,0.012974826894454151,0.07302789102439655,0.9951091045899172
1110,94904,1284,11854,1005,319,1324,13178,0.10047048110487175,0.024207011686143573,0.07626346941872818,0.9697885196374623
1111,94920,1583,14376,1360,316,1676,16052,0.10441066533765263,0.01968602043359083,0.0847246449040618,0.9445107398568019
1112,94922,24,314,18,10,28,342,0.08187134502923976,0.029239766081871343,0.05263157894736842,0.8571428571428571
1113,94923,572,4245,448,112,560,4805,0.11654526534859522,0.023309053069719043,0.09323621227887617,1.0214285714285714
1114,94924,189,2272,171,34,205,2477,0.08276140492531288,0.013726281792490917,0.06903512313282197,0.9219512195121952
1115,94925,983,10181,808,184,992,11173,0.08878546496017184,0.016468271726483488,0.07231719323368836,0.9909274193548387
1116,94926,2,92,3,2,5,97,0.05154639175257732,0.020618556701030927,0.030927835051546393,0.4
1117,94928,4664,36463,3337,430,3767,40230,0.09363658960974397,0.010688540889883172,0.0829480487198608,1.2381205203079373
1118,94929,140,1083,119,13,132,1215,0.10864197530864197,0.010699588477366255,0.09794238683127572,1.0606060606060606
1119,94930,1108,10782,869,268,1137,11919,0.09539390888497357,0.022485107811057975,0.07290880107391559,0.9744942832014072
1120,94931,1018,8828,781,123,904,9732,0.09288943690916564,0.012638717632552405,0.08025071927661323,1.1261061946902655
1121,94933,122,1159,81,36,117,1276,0.09169278996865204,0.02821316614420063,0.06347962382445141,1.0427350427350428
1122,94937,230,2471,136,121,257,2728,0.09420821114369501,0.04435483870967742,0.04985337243401759,0.8949416342412452
1123,94938,109,900,59,43,102,1002,0.10179640718562874,0.04291417165668663,0.05888223552894212,1.0686274509803921
1124,94939,736,6918,587,141,728,7646,0.09521318336385037,0.018441014909756734,0.07677216845409364,1.010989010989011
1125,94940,43,252,23,17,40,292,0.136986301369863,0.05821917808219178,0.07876712328767123,1.075
1126,94941,3583,35006,2718,872,3590,38596,0.09301482018862058,0.02259301482018862,0.07042180536843196,0.998050139275766
1127,94945,1899,19406,1565,286,1851,21257,0.0870771980994496,0.013454391494566495,0.0736228066048831,1.0259319286871962
1128,94946,79,768,54,24,78,846,0.09219858156028368,0.028368794326241134,0.06382978723404255,1.0128205128205128
1129,94947,2264,25259,1926,312,2238,27497,0.08139069716696366,0.011346692366439976,0.0700440048005237,1.0116175156389633
1130,94949,1743,14604,1472,252,1724,16328,0.10558549730524253,0.015433610975012248,0.09015188633023027,1.0110208816705337
1131,94950,5,76,3,4,7,83,0.08433734939759036,0.04819277108433735,0.03614457831325301,0.7142857142857143
1132,94951,572,5216,414,112,526,5742,0.09160571229536747,0.019505398815743643,0.07210031347962383,1.0874524714828897
1133,94952,3480,36574,2780,514,3294,39868,0.08262265476071035,0.012892545399819403,0.06973010936089094,1.0564663023679417
1134,94954,3921,41070,3359,441,3800,44870,0.08468910184978828,0.009828393135725429,0.07486070871406285,1.031842105263158
1135,94956,134,1647,113,42,155,1802,0.08601553829078801,0.023307436182019976,0.06270810210876804,0.864516129032258
1136,94957,321,2619,239,65,304,2923,0.10400273691412931,0.02223742730071844,0.08176530961341089,1.055921052631579
1137,94960,1901,19485,1600,396,1996,21481,0.092919324053815,0.0184348959545645,0.0744844280992505,0.9524048096192385
1138,94963,105,842,68,27,95,937,0.10138740661686232,0.0288153681963714,0.07257203842049093,1.105263157894737
1139,94964,11,127,7,4,11,138,0.07971014492753623,0.028985507246376812,0.050724637681159424,1.0
1140,94965,965,8826,703,267,970,9796,0.09902000816659862,0.027256022866476114,0.0717639853001225,0.9948453608247423
1141,94970,232,2045,208,60,268,2313,0.11586683960224817,0.02594033722438392,0.08992650237786425,0.8656716417910447
1142,94971,35,374,24,4,28,402,0.06965174129353234,0.009950248756218905,0.05970149253731343,1.25
1143,94972,29,153,19,12,31,184,0.16847826086956522,0.06521739130434782,0.10326086956521739,0.9354838709677419
1144,94973,237,2039,152,65,217,2256,0.09618794326241134,0.028812056737588652,0.0673758865248227,1.0921658986175116
1145,94974,3,24,5,3,8,32,0.25,0.09375,0.15625,0.375
1146,94999,3,66,4,0,4,70,0.05714285714285714,0.0,0.05714285714285714,0.75
1147,95002,212,1475,143,48,191,1666,0.11464585834333733,0.028811524609843937,0.0858343337334934,1.1099476439790577
1148,95003,3948,32902,2826,1111,3937,36839,0.10687043622248162,0.030158256195879366,0.07671218002660224,1.0027940055880111
1149,95004,484,4315,350,153,503,4818,0.10440016604400167,0.031755915317559155,0.07264425072644251,0.9622266401590457
1150,95005,934,8199,635,313,948,9147,0.10364053788127255,0.034218869574723955,0.0694216683065486,0.9852320675105485
1151,95006,1607,12444,1218,581,1799,14243,0.1263076599031103,0.040791967984272974,0.08551569191883733,0.8932740411339634
1152,95007,101,750,68,32,100,850,0.11764705882352941,0.03764705882352941,0.08,1.01
1153,95008,4016,36094,3478,411,3889,39983,0.09726633819373233,0.010279368731710977,0.08698696946202136,1.0326562098225764
1154,95010,998,10163,869,114,983,11146,0.08819307374842993,0.010227884442849453,0.07796518930558048,1.0152594099694812
1155,95012,646,6413,494,128,622,7035,0.08841506751954513,0.018194740582800285,0.07022032693674485,1.0385852090032155
1156,95013,1,57,1,1,2,59,0.03389830508474576,0.01694915254237288,0.01694915254237288,0.5
1157,95014,5251,50041,4722,560,5282,55323,0.09547566111743759,0.010122372250239502,0.08535328886719809,0.9941310109806891
1158,95017,60,623,66,8,74,697,0.10616929698708752,0.011477761836441894,0.09469153515064563,0.8108108108108109
1159,95018,1310,10293,880,485,1365,11658,0.1170869788986104,0.04160233316177732,0.07548464573683307,0.9597069597069597
1160,95019,298,3785,270,40,310,4095,0.0757020757020757,0.009768009768009768,0.06593406593406594,0.9612903225806452
1161,95020,7026,53719,5537,1028,6565,60284,0.10890120098201844,0.01705261760997943,0.09184858337203902,1.0702208682406702
1162,95021,0,30,0,1,1,31,0.03225806451612903,0.03225806451612903,0.0,0.0
1163,95023,7967,48117,5055,795,5850,53967,0.10839957751959531,0.014731224637278337,0.09366835288231697,1.3618803418803418
1164,95030,2263,15665,1582,710,2292,17957,0.12763824692320544,0.03953889847970151,0.08809934844350392,0.9873472949389179
1165,95032,3216,27065,2700,439,3139,30204,0.10392663223414117,0.014534498741888491,0.08939213349225268,1.0245301051290219
1166,95033,1726,11314,1074,642,1716,13030,0.13169608595548735,0.049270913277052956,0.08242517267843438,1.005827505827506
1167,95035,6020,49391,5194,729,5923,55314,0.10707958202263441,0.013179303612105434,0.09390027841052898,1.016376836062806
1168,95037,6274,47012,4892,925,5817,52829,0.11010997747449318,0.017509322531185523,0.09260065494330766,1.0785628330754684
1169,95039,161,959,80,24,104,1063,0.09783631232361242,0.022577610536218252,0.07525870178739416,1.5480769230769231
1170,95041,83,692,58,36,94,786,0.11959287531806616,0.04580152671755725,0.0737913486005089,0.8829787234042553
1171,95043,56,285,20,10,30,315,0.09523809523809523,0.031746031746031744,0.06349206349206349,1.8666666666666667
1172,95045,621,3752,385,98,483,4235,0.1140495867768595,0.023140495867768594,0.09090909090909091,1.2857142857142858
1173,95046,604,5410,459,130,589,5999,0.09818303050508419,0.021670278379729953,0.07651275212535423,1.0254668930390491
1174,95050,2675,24710,2326,322,2648,27358,0.09679070107463995,0.011769866218290811,0.08502083485634915,1.0101963746223566
1175,95051,4495,41184,4029,430,4459,45643,0.0976929649672458,0.009420940779528077,0.08827202418771772,1.0080735590939673
1176,95054,1366,10758,1171,156,1327,12085,0.10980554406288788,0.012908564335953662,0.09689697972693422,1.0293896006028636
1177,95060,4310,44218,3461,898,4359,48577,0.08973382464952549,0.018486114828005024,0.07124770982152047,0.9887588896535903
1178,95062,3516,39128,2983,413,3396,42524,0.07986078449816573,0.009712162543504845,0.0701486219546609,1.0353356890459364
1179,95064,31,441,34,4,38,479,0.07933194154488518,0.008350730688935281,0.0709812108559499,0.8157894736842105
1180,95065,852,8636,674,204,878,9514,0.09228505360521337,0.021442085347908344,0.07084296825730503,0.9703872437357631
1181,95066,2141,16604,1514,562,2076,18680,0.11113490364025697,0.030085653104925055,0.08104925053533191,1.03131021194605
1182,95070,4109,38105,3411,803,4214,42319,0.09957702214135494,0.018974928519104893,0.08060209362225006,0.9750830564784053
1183,95073,1504,12451,995,486,1481,13932,0.10630203847258111,0.03488372093023256,0.07141831754234855,1.0155300472653612
1184,95075,65,551,50,14,64,615,0.1040650406504065,0.022764227642276424,0.08130081300813008,1.015625
1185,95076,5657,61366,4671,1103,5774,67140,0.08599940422996723,0.016428358653559724,0.0695710455764075,0.9797367509525459
1186,95110,931,8611,777,158,935,9546,0.09794678399329562,0.016551435156086317,0.08139534883720931,0.9957219251336898
1187,95111,4555,35049,3568,688,4256,39305,0.1082813891362422,0.01750413433405419,0.09077725480218801,1.0702537593984962
1188,95112,3191,25662,2449,524,2973,28635,0.10382399161864851,0.018299284092893314,0.0855247075257552,1.0733266061217626
1189,95113,10,82,11,2,13,95,0.1368421052631579,0.021052631578947368,0.11578947368421053,0.7692307692307693
1190,95116,2941,23223,2375,452,2827,26050,0.10852207293666027,0.017351247600767755,0.09117082533589252,1.0403254333215424
1191,95117,1613,14749,1438,169,1607,16356,0.09825140621178773,0.010332599657618,0.08791880655416973,1.0037336652146858
1192,95118,3191,30719,2865,331,3196,33915,0.09423558897243108,0.00975969335102462,0.08447589562140646,0.9984355444305382
1193,95119,1212,10231,975,124,1099,11330,0.0969991173874669,0.010944395410414828,0.08605472197705208,1.102820746132848
1194,95120,4567,44703,3957,578,4535,49238,0.09210365977497055,0.011738900848937812,0.08036475892603274,1.0070562293274532
1195,95121,3663,29656,3150,489,3639,33295,0.10929569004355008,0.014686889923411923,0.09460880012013816,1.0065952184666116
1196,95122,3576,29841,2786,543,3329,33170,0.1003617726861622,0.016370214048839312,0.08399155863732288,1.0741964553920096
1197,95123,6342,54627,5526,632,6158,60785,0.10130788845932384,0.010397301965945545,0.0909105864933783,1.029879831113998
1198,95124,5654,53426,5046,559,5605,59031,0.09495011095864885,0.009469600718266673,0.08548051024038217,1.0087421944692239
1199,95125,6028,51740,5318,733,6051,57791,0.10470488484366078,0.012683635860255057,0.09202124898340572,0.9961989753759709
1200,95126,1989,17400,1672,257,1929,19329,0.0997982306379016,0.013296083604945936,0.08650214703295567,1.0311041990668741
1201,95127,5382,46461,4459,863,5322,51783,0.1027750420022015,0.016665701098816214,0.08610934090338528,1.0112739571589628
1202,95128,2817,25081,2419,341,2760,27841,0.09913437017348514,0.012248123271434215,0.08688624690205093,1.0206521739130434
1203,95129,3172,33032,2912,272,3184,36216,0.08791694278771814,0.007510492599955821,0.08040645018776231,0.9962311557788944
1204,95130,1309,13303,1185,122,1307,14610,0.08945927446954141,0.008350444900752908,0.0811088295687885,1.0015302218821729
1205,95131,2555,20344,2155,287,2442,22786,0.10717106995523568,0.012595453348547354,0.09457561660668831,1.0462735462735462
1206,95132,3922,37644,3522,437,3959,41603,0.09516140662932962,0.010504050188688316,0.0846573564406413,0.9906542056074766
1207,95133,1879,16827,1637,212,1849,18676,0.09900406939387449,0.011351467123581066,0.08765260227029342,1.016224986479178
1208,95134,613,3130,442,157,599,3729,0.16063287744703675,0.04210244033252883,0.1185304371145079,1.023372287145242
1209,95135,2093,16635,1873,249,2122,18757,0.11313109772351655,0.013275043983579463,0.09985605373993708,0.9863336475023563
1210,95136,3995,30404,3312,454,3766,34170,0.11021363769388352,0.013286508633304068,0.09692712906057946,1.0608072225172598
1211,95138,2364,17017,1991,332,2323,19340,0.12011375387797311,0.017166494312306102,0.10294725956566701,1.0176495910460612
1212,95139,752,6872,650,67,717,7589,0.09447885096850706,0.008828567663723811,0.08565028330478323,1.0488145048814506
1213,95140,51,404,40,14,54,458,0.11790393013100436,0.03056768558951965,0.08733624454148471,0.9444444444444444
1214,95141,4,48,3,1,4,52,0.07692307692307693,0.019230769230769232,0.057692307692307696,1.0
1215,95148,4997,40599,4400,573,4973,45572,0.10912402352321601,0.01257351005003072,0.09655051347318529,1.004826060727931
1216,95202,349,1517,236,98,334,1851,0.1804430037817396,0.05294435440302539,0.12749864937871422,1.0449101796407185
1217,95203,2140,12152,1504,504,2008,14160,0.14180790960451978,0.03559322033898305,0.10621468926553672,1.0657370517928286
1218,95204,4867,32706,3696,1044,4740,37446,0.12658227848101267,0.027880147412273674,0.09870213106873899,1.0267932489451477
1219,95205,4652,26627,3281,1236,4517,31144,0.1450359619830465,0.039686617004880555,0.10534934497816593,1.0298870932034536
1220,95206,8319,51237,6045,1674,7719,58956,0.13092814980663545,0.028394056584571545,0.10253409322206392,1.0777302759424796
1221,95207,4770,33365,3826,903,4729,38094,0.12414028455924818,0.023704520396912898,0.10043576416233528,1.0086699090716853
1222,95209,6061,42404,4893,799,5692,48096,0.11834664005322688,0.016612608117099133,0.10173403193612775,1.064827828531272
1223,95210,4258,29264,3351,809,4160,33424,0.12446146481570129,0.02420416467209191,0.10025730014360938,1.0235576923076923
1224,95212,3777,25634,3053,517,3570,29204,0.12224352828379674,0.017703054376112862,0.10454047390768388,1.057983193277311
1225,95215,2639,17582,1796,696,2492,20074,0.12414067948590216,0.034671714655773636,0.08946896483012852,1.0589887640449438
1226,95219,3821,26991,3065,522,3587,30578,0.11730656027209105,0.017071096867028582,0.10023546340506247,1.0652355729021465
1227,95220,882,6216,634,203,837,7053,0.11867290514674607,0.028782078548135547,0.08989082659861052,1.053763440860215
1228,95221,3,103,6,7,13,116,0.11206896551724138,0.0603448275862069,0.05172413793103448,0.23076923076923078
1229,95222,1194,6776,808,296,1104,7880,0.1401015228426396,0.03756345177664975,0.10253807106598985,1.0815217391304348
1230,95223,3497,18900,2117,1758,3875,22775,0.17014270032930845,0.07718990120746433,0.09295279912184412,0.9024516129032258
1231,95224,98,594,51,58,109,703,0.155049786628734,0.08250355618776671,0.07254623044096728,0.8990825688073395
1232,95225,125,823,93,38,131,954,0.13731656184486374,0.039832285115303984,0.09748427672955975,0.9541984732824428
1233,95226,20,71,7,8,15,86,0.1744186046511628,0.09302325581395349,0.08139534883720931,1.3333333333333333
1234,95227,103,696,84,23,107,803,0.13325031133250312,0.028642590286425903,0.10460772104607721,0.9626168224299065
1235,95228,1616,8538,1050,477,1527,10065,0.15171385991058123,0.047391952309985094,0.10432190760059612,1.0582842174197773
1236,95229,23,121,20,14,34,155,0.21935483870967742,0.09032258064516129,0.12903225806451613,0.6764705882352942
1237,95230,51,318,37,14,51,369,0.13821138211382114,0.037940379403794036,0.1002710027100271,1.0
1238,95231,318,2000,207,91,298,2298,0.12967798085291557,0.03959965187119234,0.09007832898172324,1.0671140939597314
1239,95232,67,428,38,28,66,494,0.13360323886639677,0.05668016194331984,0.07692307692307693,1.0151515151515151
1240,95233,136,591,63,65,128,719,0.1780250347705146,0.09040333796940195,0.08762169680111266,1.0625
1241,95236,405,3321,331,66,397,3718,0.10677783754706832,0.01775147928994083,0.08902635825712749,1.0201511335012594
1242,95237,533,3557,385,109,494,4051,0.12194519871636633,0.026906936558874352,0.09503826215749198,1.0789473684210527
1243,95240,5089,37028,3888,907,4795,41823,0.11464983382349425,0.021686631757645316,0.09296320206584893,1.0613138686131387
1244,95241,1,100,4,5,9,109,0.08256880733944955,0.045871559633027525,0.03669724770642202,0.1111111111111111
1245,95242,4494,29884,3298,528,3826,33710,0.11349747849302877,0.015663008009492732,0.09783447048353604,1.174594877156299
1246,95245,593,2350,295,222,517,2867,0.18032786885245902,0.0774328566445762,0.1028950122078828,1.1470019342359767
1247,95246,398,2042,243,149,392,2434,0.16105176663927692,0.061216105176663926,0.09983566146261298,1.0153061224489797
1248,95247,1304,6285,773,582,1355,7640,0.17735602094240838,0.07617801047120419,0.10117801047120419,0.9623616236162361
1249,95248,91,488,48,45,93,581,0.16006884681583478,0.0774526678141136,0.08261617900172118,0.978494623655914
1250,95249,671,4135,416,232,648,4783,0.13547982437800543,0.04850512230817479,0.08697470206983066,1.0354938271604939
1251,95251,149,793,90,79,169,962,0.17567567567567569,0.08212058212058213,0.09355509355509356,0.8816568047337278
1252,95252,3244,17933,2140,856,2996,20929,0.1431506522050743,0.04090018634430694,0.10225046586076736,1.0827770360480642
1253,95253,22,142,13,5,18,160,0.1125,0.03125,0.08125,1.2222222222222223
1254,95254,126,794,106,25,131,925,0.14162162162162162,0.02702702702702703,0.11459459459459459,0.9618320610687023
1255,95255,524,2134,241,249,490,2624,0.18673780487804878,0.09489329268292683,0.09184451219512195,1.0693877551020408
1256,95257,178,666,76,98,174,840,0.20714285714285716,0.11666666666666667,0.09047619047619047,1.0229885057471264
1257,95258,508,4775,451,83,534,5309,0.10058391410811829,0.015633829346392916,0.08495008476172537,0.951310861423221
1258,95301,4529,32264,3568,603,4171,36435,0.11447783724440785,0.016550020584602716,0.09792781665980513,1.085830736034524
1259,95303,34,302,32,8,40,342,0.11695906432748537,0.023391812865497075,0.0935672514619883,0.85
1260,95304,1736,11606,1370,244,1614,13220,0.12208774583963691,0.018456883509833585,0.10363086232980333,1.0755885997521686
1261,95305,17,160,9,4,13,173,0.07514450867052024,0.023121387283236993,0.05202312138728324,1.3076923076923077
1262,95306,193,1061,110,50,160,1221,0.13104013104013104,0.04095004095004095,0.09009009009009009,1.20625
1263,95307,4919,34934,3926,765,4691,39625,0.11838485804416404,0.019305993690851734,0.0990788643533123,1.0486037092304412
1264,95309,25,212,21,15,36,248,0.14516129032258066,0.06048387096774194,0.0846774193548387,0.6944444444444444
1265,95310,446,2147,235,262,497,2644,0.18797276853252648,0.09909228441754916,0.0888804841149773,0.89738430583501
1266,95311,421,2282,258,247,505,2787,0.18119842124147828,0.08862576246860424,0.09257265877287406,0.8336633663366336
1267,95312,16,104,13,4,17,121,0.14049586776859505,0.03305785123966942,0.10743801652892562,0.9411764705882353
1268,95313,69,576,47,18,65,641,0.10140405616224649,0.028081123244929798,0.07332293291731669,1.0615384615384615
1269,95315,1211,9708,884,225,1109,10817,0.1025238051215679,0.02080059166127392,0.08172321346029399,1.0919747520288547
1270,95316,861,6077,648,104,752,6829,0.11011861180260653,0.015229169717381754,0.09488944208522478,1.1449468085106382
1271,95317,13,123,19,3,22,145,0.15172413793103448,0.020689655172413793,0.1310344827586207,0.5909090909090909
1272,95318,23,284,12,13,25,309,0.08090614886731391,0.042071197411003236,0.038834951456310676,0.92
1273,95319,169,1305,144,41,185,1490,0.12416107382550336,0.027516778523489934,0.09664429530201342,0.9135135135135135
1274,95320,1455,11379,1174,221,1395,12774,0.10920620009394082,0.017300767183341163,0.09190543291059966,1.043010752688172
1275,95321,2005,8531,1114,1037,2151,10682,0.20136678524620857,0.09707919865193784,0.10428758659427073,0.9321245932124593
1276,95322,1117,8686,851,203,1054,9740,0.1082135523613963,0.02084188911704312,0.08737166324435318,1.0597722960151803
1277,95323,96,737,59,24,83,820,0.10121951219512196,0.02926829268292683,0.07195121951219512,1.1566265060240963
1278,95324,822,6095,564,118,682,6777,0.10063449904087354,0.017411834144901873,0.08322266489597167,1.2052785923753666
1279,95325,14,64,9,7,16,80,0.2,0.0875,0.1125,0.875
1280,95326,1217,8424,898,177,1075,9499,0.11316980734814192,0.018633540372670808,0.0945362669754711,1.132093023255814
1281,95327,1189,6094,735,494,1229,7323,0.16782739314488598,0.06745869179298102,0.10036870135190495,0.967453213995118
1282,95328,609,3612,433,119,552,4164,0.13256484149855907,0.028578290105667627,0.10398655139289145,1.1032608695652173
1283,95329,747,3714,456,379,835,4549,0.18355682567597273,0.0833150142888547,0.10024181138711805,0.8946107784431138
1284,95330,5733,23960,3491,535,4026,27986,0.14385764310726792,0.01911670120774673,0.12474094189952119,1.4239940387481371
1285,95333,231,1736,179,77,256,1992,0.1285140562248996,0.038654618473895584,0.08985943775100401,0.90234375
1286,95334,1814,11350,1152,255,1407,12757,0.1102923884925923,0.01998902563298581,0.0903033628596065,1.289267945984364
1287,95335,467,2378,265,193,458,2836,0.1614950634696756,0.06805359661495064,0.09344146685472496,1.019650655021834
1288,95336,6603,47730,5392,853,6245,53975,0.11570171375636869,0.015803612783696155,0.09989810097267253,1.057325860688551
1289,95337,7584,37956,4943,724,5667,43623,0.12990853448868717,0.016596749421176903,0.11331178506751026,1.3382742191635786
1290,95338,1913,13783,1323,746,2069,15852,0.13051980822609136,0.04706030784759021,0.08345950037850114,0.9246012566457226
1291,95340,5381,37494,4254,756,5010,42504,0.11787125917560701,0.017786561264822136,0.10008469791078486,1.074051896207585
1292,95341,3555,18914,2087,420,2507,21421,0.11703468558890807,0.01960692778114934,0.09742775780775874,1.4180295173514161
1293,95345,84,626,55,36,91,717,0.12691771269177127,0.0502092050209205,0.07670850767085077,0.9230769230769231
1294,95346,624,2826,325,433,758,3584,0.21149553571428573,0.12081473214285714,0.09068080357142858,0.8232189973614775
1295,95348,4965,25855,3289,488,3777,29632,0.12746355291576675,0.016468682505399568,0.11099487041036717,1.3145353455123114
1296,95350,6840,51713,5603,1064,6667,58380,0.11420006851661528,0.018225419664268584,0.09597464885234669,1.0259487025648717
1297,95351,5037,33949,3674,1206,4880,38829,0.12567926034664811,0.031059259831569187,0.09462000051507893,1.032172131147541
1298,95352,1,70,3,2,5,75,0.06666666666666667,0.02666666666666667,0.04,0.2
1299,95354,3893,24365,2954,759,3713,28078,0.1322387634446898,0.027031839874634946,0.10520692357005484,1.04847831941826
1300,95355,8289,60085,6656,978,7634,67719,0.11273054829516088,0.014442032516723519,0.09828851577843736,1.0858003667801939
1301,95356,4574,31162,3584,633,4217,35379,0.11919500268520875,0.017891969812600696,0.10130303287260804,1.0846573393407635
1302,95357,1594,11766,1258,230,1488,13254,0.11226799456767768,0.017353251848498567,0.09491474271917912,1.071236559139785
1303,95358,3384,23862,2569,713,3282,27144,0.12091069849690539,0.02626731506041851,0.09464338343648689,1.0310786106032908
1304,95360,1678,11720,1251,256,1507,13227,0.11393362062448023,0.019354350948816813,0.09457926967566342,1.1134704711347048
1305,95361,4948,34092,3964,723,4687,38779,0.12086438536321205,0.01864411150364888,0.10222027385956317,1.0556859398335823
1306,95363,4157,24706,3180,538,3718,28424,0.13080495356037153,0.0189276667604841,0.11187728679988741,1.118074233458849
1307,95364,210,1317,109,85,194,1511,0.128391793514229,0.05625413633355394,0.07213765718067505,1.0824742268041236
1308,95365,477,3194,320,72,392,3586,0.10931399888455103,0.020078081427774678,0.08923591745677635,1.2168367346938775
1309,95366,2338,18327,1830,253,2083,20410,0.1020578147966683,0.012395884370406663,0.08966193042626164,1.1224195871339415
1310,95367,3389,24031,2840,425,3265,27296,0.11961459554513482,0.015570046893317702,0.10404454865181711,1.037978560490046
1311,95368,1837,14495,1562,267,1829,16324,0.11204361676059789,0.016356285224209753,0.09568733153638814,1.0043739748496445
1312,95369,93,669,63,20,83,752,0.11037234042553191,0.026595744680851064,0.08377659574468085,1.1204819277108433
1313,95370,6966,29639,3465,3087,6552,36191,0.18103948495482303,0.08529744964217623,0.09574203531264679,1.0631868131868132
1314,95372,515,2178,242,200,442,2620,0.1687022900763359,0.07633587786259542,0.09236641221374046,1.165158371040724
1315,95374,136,768,75,30,105,873,0.12027491408934708,0.03436426116838488,0.0859106529209622,1.2952380952380953
1316,95375,167,1099,73,100,173,1272,0.1360062893081761,0.07861635220125786,0.05738993710691824,0.9653179190751445
1317,95376,6695,49118,5673,866,6539,55657,0.11748746788364446,0.015559588191961479,0.10192787969168299,1.0238568588469186
1318,95377,5968,32060,4248,492,4740,36800,0.12880434782608696,0.013369565217391305,0.11543478260869565,1.2590717299578058
1319,95379,808,4223,428,325,753,4976,0.15132636655948553,0.06531350482315113,0.0860128617363344,1.0730411686586985
1320,95380,4883,31315,3448,764,4212,35527,0.11855771666619754,0.021504771019224815,0.09705294564697273,1.159306742640076
1321,95381,1,165,17,4,21,186,0.11290322580645161,0.021505376344086023,0.0913978494623656,0.047619047619047616
1322,95382,5024,35581,4127,600,4727,40308,0.11727200555720949,0.014885382554331646,0.10238662300287785,1.0628305479162259
1323,95383,1923,8231,876,1190,2066,10297,0.2006409633873944,0.11556764106050306,0.08507332232689133,0.930784123910939
1324,95385,7,86,11,4,15,101,0.1485148514851485,0.039603960396039604,0.10891089108910891,0.4666666666666667
1325,95386,1258,8567,951,234,1185,9752,0.1215135356849877,0.023995077932731746,0.09751845775225594,1.0616033755274261
1326,95387,18,150,19,4,23,173,0.1329479768786127,0.023121387283236993,0.10982658959537572,0.782608695652174
1327,95388,1403,9281,1030,207,1237,10518,0.11760791024909678,0.019680547632629778,0.097927362616467,1.1341956345998383
1328,95389,79,886,63,51,114,1000,0.114,0.051,0.063,0.6929824561403509
1329,95391,5999,19709,3814,349,4163,23872,0.17438840482573725,0.014619638069705093,0.15976876675603216,1.4410281047321643
1330,95401,3858,33914,3097,455,3552,37466,0.09480595740137725,0.012144344205412909,0.08266161319596434,1.0861486486486487
1331,95402,1,59,6,2,8,67,0.11940298507462686,0.029850746268656716,0.08955223880597014,0.125
1332,95403,5437,38663,4415,709,5124,43787,0.1170210336401215,0.01619202046269441,0.1008290131774271,1.0610850897736144
1333,95404,5296,43226,4556,956,5512,48738,0.11309450531412861,0.019615084738807503,0.0934794205753211,0.9608127721335269
1334,95405,2572,24856,2250,354,2604,27460,0.09482884195193007,0.012891478514202477,0.0819373634377276,0.9877112135176651
1335,95407,3539,28563,2680,519,3199,31762,0.10071783892701971,0.016340280838738116,0.0843775580882816,1.10628321350422
1336,95409,4327,33084,3451,597,4048,37132,0.10901648174081655,0.01607777658084671,0.09293870515996984,1.0689229249011858
1337,95410,172,1451,96,64,160,1611,0.09931719428926133,0.03972687771570453,0.0595903165735568,1.075
1338,95412,90,636,107,23,130,766,0.16971279373368145,0.030026109660574413,0.13968668407310705,0.6923076923076923
1339,95415,153,1214,69,40,109,1323,0.08238851095993953,0.030234315948601664,0.05215419501133787,1.4036697247706422
1340,95416,11,46,9,0,9,55,0.16363636363636364,0.0,0.16363636363636364,1.2222222222222223
1341,95417,25,186,14,11,25,211,0.11848341232227488,0.052132701421800945,0.06635071090047394,1.0
1342,95419,157,884,83,57,140,1024,0.13671875,0.0556640625,0.0810546875,1.1214285714285714
1343,95420,37,485,26,15,41,526,0.0779467680608365,0.028517110266159697,0.049429657794676805,0.9024390243902439
1344,95421,343,2850,204,135,339,3189,0.10630291627469426,0.04233301975540922,0.06396989651928504,1.0117994100294985
1345,95422,2777,17640,2116,835,2951,20591,0.14331504055169733,0.04055169734349959,0.10276334320819776,0.9410369366316503
1346,95423,1144,7120,850,281,1131,8251,0.13707429402496668,0.03405647800266634,0.10301781602230033,1.0114942528735633
1347,95424,43,519,56,14,70,589,0.11884550084889643,0.023769100169779286,0.09507640067911714,0.6142857142857143
1348,95425,1532,12559,1192,268,1460,14019,0.10414437549040588,0.019116912761252585,0.08502746272915329,1.0493150684931507
1349,95426,426,2592,252,146,398,2990,0.1331103678929766,0.04882943143812709,0.08428093645484949,1.07035175879397
1350,95427,51,510,21,20,41,551,0.07441016333938294,0.036297640653357534,0.038112522686025406,1.2439024390243902
1351,95428,179,1225,139,64,203,1428,0.14215686274509803,0.04481792717086835,0.09733893557422969,0.8817733990147784
1352,95429,7,76,4,6,10,86,0.11627906976744186,0.06976744186046512,0.046511627906976744,0.7
1353,95430,13,262,15,5,20,282,0.07092198581560284,0.01773049645390071,0.05319148936170213,0.65
1354,95432,43,598,30,15,45,643,0.06998444790046657,0.02332814930015552,0.04665629860031104,0.9555555555555556
1355,95433,11,171,14,4,18,189,0.09523809523809523,0.021164021164021163,0.07407407407407407,0.6111111111111112
1356,95435,6,110,6,0,6,116,0.05172413793103448,0.0,0.05172413793103448,1.0
1357,95436,1031,8511,756,305,1061,9572,0.11084412870873381,0.03186376932720435,0.07898035938152946,0.9717247879359096
1358,95437,2277,18508,1507,609,2116,20624,0.10259891388673391,0.029528704422032582,0.07307020946470132,1.076086956521739
1359,95439,58,725,42,14,56,781,0.07170294494238157,0.01792573623559539,0.05377720870678617,1.0357142857142858
1360,95441,220,1704,137,51,188,1892,0.09936575052854123,0.026955602536997886,0.07241014799154334,1.1702127659574468
1361,95442,566,4471,417,143,560,5031,0.11130987875173921,0.028423772609819122,0.0828861061419201,1.0107142857142857
1362,95443,56,471,50,19,69,540,0.12777777777777777,0.03518518518518519,0.09259259259259259,0.8115942028985508
1363,95444,107,980,73,16,89,1069,0.0832553788587465,0.014967259120673527,0.06828811973807297,1.202247191011236
1364,95445,585,4029,384,172,556,4585,0.12126499454743729,0.03751363140676118,0.08375136314067612,1.0521582733812949
1365,95446,1454,9857,979,492,1471,11328,0.12985522598870056,0.04343220338983051,0.08642302259887005,0.9884432358939497
1366,95448,2340,19841,1772,432,2204,22045,0.09997731911998185,0.019596280335677025,0.08038103878430483,1.061705989110708
1367,95449,176,1065,112,24,136,1201,0.11323896752706078,0.019983347210657785,0.093255620316403,1.2941176470588236
1368,95450,132,989,106,40,146,1135,0.12863436123348018,0.03524229074889868,0.0933920704845815,0.9041095890410958
1369,95451,2512,15656,1802,735,2537,18193,0.13944923871818832,0.040400153905348214,0.09904908481284011,0.9901458415451321
1370,95452,252,2419,218,51,269,2688,0.10007440476190477,0.018973214285714284,0.08110119047619048,0.9368029739776952
1371,95453,2009,14144,1529,427,1956,16100,0.12149068322981367,0.026521739130434784,0.09496894409937888,1.0270961145194275
1372,95454,277,1933,175,116,291,2224,0.13084532374100719,0.052158273381294966,0.07868705035971223,0.9518900343642611
1373,95456,190,1485,127,57,184,1669,0.11024565608148593,0.0341521869382864,0.07609346914319952,1.0326086956521738
1374,95457,587,4012,406,181,587,4599,0.12763644270493585,0.039356381822135245,0.0882800608828006,1.0
1375,95458,715,4598,524,208,732,5330,0.1373358348968105,0.03902439024390244,0.09831144465290807,0.976775956284153
1376,95459,141,1028,93,36,129,1157,0.111495246326707,0.03111495246326707,0.08038029386343994,1.0930232558139534
1377,95460,539,4324,362,124,486,4810,0.10103950103950105,0.02577962577962578,0.07525987525987526,1.1090534979423867
1378,95461,547,3847,370,135,505,4352,0.11603860294117647,0.031020220588235295,0.08501838235294118,1.0831683168316832
1379,95462,441,3195,330,140,470,3665,0.12824010914051842,0.03819918144611187,0.09004092769440655,0.9382978723404255
1380,95463,52,228,35,12,47,275,0.1709090909090909,0.04363636363636364,0.12727272727272726,1.1063829787234043
1381,95464,462,3119,374,133,507,3626,0.1398234969663541,0.03667953667953668,0.10314396028681742,0.9112426035502958
1382,95465,264,2267,156,72,228,2495,0.09138276553106213,0.028857715430861724,0.0625250501002004,1.1578947368421053
1383,95466,151,902,64,40,104,1006,0.10337972166998012,0.039761431411530816,0.0636182902584493,1.4519230769230769
1384,95467,1480,8554,1023,330,1353,9907,0.1365701019481175,0.03330978096295548,0.10326032098516201,1.0938654841093864
1385,95468,138,1331,120,36,156,1487,0.10490921318090114,0.0242098184263618,0.08069939475453934,0.8846153846153846
1386,95469,225,1794,150,75,225,2019,0.11144130757800892,0.03714710252600297,0.07429420505200594,1.0
1387,95470,726,6048,496,218,714,6762,0.10559006211180125,0.03223898254954156,0.07335107956225968,1.0168067226890756
1388,95471,60,529,56,29,85,614,0.13843648208469056,0.04723127035830619,0.09120521172638436,0.7058823529411765
1389,95472,3641,35886,2721,715,3436,39322,0.08738110981130157,0.018183205330349422,0.06919790448095214,1.059662398137369
1390,95476,5088,42661,4158,794,4952,47613,0.10400520866150001,0.016676117866969105,0.08732909079453091,1.0274636510500808
1391,95481,4,22,4,0,4,26,0.15384615384615385,0.0,0.15384615384615385,1.0
1392,95482,3446,28386,2565,727,3292,31678,0.10392070206452428,0.022949681166740326,0.08097102089778395,1.0467800729040098
1393,95485,343,2496,239,104,343,2839,0.12081718915110955,0.03663261711870377,0.08418457203240577,1.0
1394,95486,20,216,28,11,39,255,0.15294117647058825,0.043137254901960784,0.10980392156862745,0.5128205128205128
1395,95488,39,347,21,15,36,383,0.09399477806788512,0.0391644908616188,0.05483028720626632,1.0833333333333333
1396,95490,2006,13903,1268,651,1919,15822,0.12128681582606497,0.041145240803943876,0.0801415750221211,1.0453361125586242
1397,95492,3454,32230,2989,455,3444,35674,0.09654089813309413,0.012754386948477883,0.08378651118461625,1.0029036004645762
1398,95493,32,187,19,10,29,216,0.13425925925925927,0.046296296296296294,0.08796296296296297,1.103448275862069
1399,95494,52,349,37,18,55,404,0.13613861386138615,0.04455445544554455,0.09158415841584158,0.9454545454545454
1400,95497,766,4688,534,113,647,5335,0.12127460168697282,0.021180880974695407,0.10009372071227741,1.1839258114374034
1401,95501,2643,24097,2103,539,2642,26739,0.09880698605033846,0.020157821908074348,0.07864916414226411,1.0003785011355033
1402,95502,0,64,7,8,15,79,0.189873417721519,0.10126582278481013,0.08860759493670886,0.0
1403,95503,3407,30708,2651,632,3283,33991,0.09658438998558443,0.018593157012150276,0.07799123297343415,1.0377703320134024
1404,95511,11,117,18,11,29,146,0.19863013698630136,0.07534246575342465,0.1232876712328767,0.3793103448275862
1405,95514,10,68,8,3,11,79,0.13924050632911392,0.0379746835443038,0.10126582278481013,0.9090909090909091
1406,95519,2482,21992,1917,383,2300,24292,0.09468137658488392,0.015766507492178495,0.07891486909270541,1.0791304347826087
1407,95521,1951,18371,1528,338,1866,20237,0.0922073429856204,0.01670208034787765,0.07550526263774275,1.0455519828510182
1408,95524,217,2443,178,40,218,2661,0.08192408868846299,0.01503194287861706,0.06689214580984593,0.9954128440366973
1409,95525,192,1939,164,38,202,2141,0.09434843531060252,0.017748715553479684,0.07659971975712283,0.9504950495049505
1410,95526,56,602,53,19,72,674,0.10682492581602374,0.028189910979228485,0.07863501483679525,0.7777777777777778
1411,95527,34,502,38,22,60,562,0.10676156583629894,0.03914590747330961,0.06761565836298933,0.5666666666666667
1412,95528,157,1292,117,45,162,1454,0.11141678129298486,0.030949105914718018,0.08046767537826685,0.9691358024691358
1413,95531,3002,22045,2295,629,2924,24969,0.11710521046097161,0.025191237134046217,0.09191397332692539,1.0266757865937073
1414,95536,288,2809,198,49,247,3056,0.08082460732984294,0.016034031413612565,0.06479057591623037,1.165991902834008
1415,95537,38,348,36,1,37,385,0.09610389610389611,0.0025974025974025974,0.09350649350649351,1.027027027027027
1416,95540,1880,15775,1460,313,1773,17548,0.1010371552313654,0.017836790517437886,0.08320036471392751,1.060349689791314
1417,95542,244,1958,136,116,252,2210,0.11402714932126697,0.05248868778280543,0.06153846153846154,0.9682539682539683
1418,95543,133,971,71,50,121,1092,0.1108058608058608,0.045787545787545784,0.06501831501831502,1.0991735537190082
1419,95545,3,116,6,8,14,130,0.1076923076923077,0.06153846153846154,0.046153846153846156,0.21428571428571427
1420,95546,60,701,66,29,95,796,0.11934673366834171,0.0364321608040201,0.0829145728643216,0.631578947368421
1421,95547,167,1516,128,33,161,1677,0.09600477042337507,0.01967799642218247,0.0763267740011926,1.0372670807453417
1422,95548,135,909,78,47,125,1034,0.12088974854932302,0.045454545454545456,0.07543520309477757,1.08
1423,95549,100,1067,92,23,115,1182,0.09729272419627749,0.0194585448392555,0.077834179357022,0.8695652173913043
1424,95550,3,56,4,0,4,60,0.06666666666666667,0.0,0.06666666666666667,0.75
1425,95551,203,1590,163,30,193,1783,0.10824453168816602,0.01682557487380819,0.09141895681435783,1.0518134715025906
1426,95552,35,460,45,22,67,527,0.127134724857685,0.04174573055028463,0.08538899430740038,0.5223880597014925
1427,95553,97,620,62,47,109,729,0.149519890260631,0.0644718792866941,0.0850480109739369,0.8899082568807339
1428,95554,53,415,41,31,72,487,0.14784394250513347,0.06365503080082136,0.08418891170431211,0.7361111111111112
1429,95555,45,322,39,20,59,381,0.15485564304461943,0.05249343832020997,0.10236220472440945,0.7627118644067796
1430,95556,38,299,22,23,45,344,0.1308139534883721,0.06686046511627906,0.06395348837209303,0.8444444444444444
1431,95558,42,362,34,14,48,410,0.11707317073170732,0.03414634146341464,0.08292682926829269,0.875
1432,95559,10,120,15,13,28,148,0.1891891891891892,0.08783783783783784,0.10135135135135136,0.35714285714285715
1433,95560,204,1624,139,128,267,1891,0.14119513484928609,0.06768905341089371,0.07350608143839238,0.7640449438202247
1434,95562,543,3914,395,143,538,4452,0.12084456424079065,0.032120395327942496,0.08872416891284816,1.0092936802973977
1435,95563,78,824,54,58,112,936,0.11965811965811966,0.06196581196581197,0.057692307692307696,0.6964285714285714
1436,95564,33,230,25,9,34,264,0.12878787878787878,0.03409090909090909,0.0946969696969697,0.9705882352941176
1437,95565,143,372,53,16,69,441,0.1564625850340136,0.036281179138321996,0.12018140589569161,2.072463768115942
1438,95567,316,2280,227,64,291,2571,0.11318553092182031,0.024893037728510307,0.08829249319330999,1.0859106529209621
1439,95568,6,76,8,4,12,88,0.13636363636363635,0.045454545454545456,0.09090909090909091,0.5
1440,95569,24,200,19,11,30,230,0.13043478260869565,0.04782608695652174,0.08260869565217391,0.8
1441,95570,460,3836,374,101,475,4311,0.11018325214567386,0.023428438877290653,0.0867548132683832,0.968421052631579
1442,95571,28,311,26,4,30,341,0.08797653958944282,0.011730205278592375,0.07624633431085044,0.9333333333333333
1443,95573,287,2424,236,107,343,2767,0.12396096855800506,0.038670039754246474,0.08529092880375859,0.8367346938775511
1444,95585,28,240,13,10,23,263,0.08745247148288973,0.03802281368821293,0.049429657794676805,1.2173913043478262
1445,95587,26,147,18,21,39,186,0.20967741935483872,0.11290322580645161,0.0967741935483871,0.6666666666666666
1446,95589,385,2115,257,104,361,2476,0.14579967689822293,0.0420032310177706,0.10379644588045234,1.0664819944598338
1447,95595,10,110,18,5,23,133,0.17293233082706766,0.03759398496240601,0.13533834586466165,0.43478260869565216
1448,95601,95,422,64,44,108,530,0.2037735849056604,0.0830188679245283,0.12075471698113208,0.8796296296296297
1449,95602,4821,20323,2646,1998,4644,24967,0.18600552729603076,0.0800256338366644,0.10597989345936637,1.0381136950904393
1450,95603,5545,31924,3494,1804,5298,37222,0.1423351781204664,0.048465960990811886,0.0938692171296545,1.0466213665534163
1451,95605,1526,10666,1199,314,1513,12179,0.12423023236718943,0.025782083914935545,0.09844814845225389,1.0085922009253139
1452,95606,24,124,21,9,30,154,0.19480519480519481,0.05844155844155844,0.13636363636363635,0.8
1453,95607,30,249,29,8,37,286,0.12937062937062938,0.027972027972027972,0.10139860139860139,0.8108108108108109
1454,95608,7916,60670,6609,1127,7736,68406,0.11308949507353157,0.016475162997397888,0.09661433207613367,1.0232678386763185
1455,95610,5477,39042,4512,792,5304,44346,0.11960492490867271,0.01785955892301448,0.10174536598565824,1.0326168929110107
1456,95612,100,837,75,27,102,939,0.10862619808306709,0.02875399361022364,0.07987220447284345,0.9803921568627451
1457,95613,60,435,41,30,71,506,0.14031620553359683,0.05928853754940711,0.08102766798418973,0.8450704225352113
1458,95614,1324,5204,716,515,1231,6435,0.1912975912975913,0.08003108003108003,0.11126651126651127,1.075548334687246
1459,95615,60,458,48,20,68,526,0.12927756653992395,0.03802281368821293,0.09125475285171103,0.8823529411764706
1460,95616,2937,33096,2574,283,2857,35953,0.07946485689650377,0.007871387644980948,0.07159346925152282,1.0280014000700035
1461,95617,2,25,9,1,10,35,0.2857142857142857,0.02857142857142857,0.2571428571428571,0.2
1462,95618,2510,23635,2022,258,2280,25915,0.08797993440092611,0.00995562415589427,0.07802431024503184,1.1008771929824561
1463,95619,918,5473,584,326,910,6383,0.1425661914460285,0.05107316308945637,0.09149302835657215,1.0087912087912088
1464,95620,2905,19965,2120,265,2385,22350,0.10671140939597315,0.01185682326621924,0.09485458612975392,1.2180293501048218
1465,95621,6536,43760,5397,932,6329,50089,0.12635508794346065,0.01860687975403781,0.10774820818942282,1.0327065887185969
1466,95623,1100,5212,629,490,1119,6331,0.1767493287000474,0.07739693571315748,0.0993523929868899,0.9830205540661304
1467,95624,10150,67988,8180,1152,9332,77320,0.1206932229694775,0.014899120538023797,0.1057941024314537,1.0876553793399057
1468,95625,35,222,33,7,40,262,0.15267175572519084,0.026717557251908396,0.12595419847328243,0.875
1469,95626,917,6721,698,185,883,7604,0.11612309310889006,0.02432930036822725,0.09179379274066281,1.0385050962627407
1470,95627,408,3416,312,91,403,3819,0.10552500654621629,0.023828227284629484,0.0816967792615868,1.0124069478908189
1471,95628,6949,50600,5717,976,6693,57293,0.11682055399437977,0.01703523990714398,0.09978531408723579,1.038248916778724
1472,95629,245,1209,135,91,226,1435,0.15749128919860628,0.06341463414634146,0.09407665505226481,1.084070796460177
1473,95630,12388,78486,9449,1398,10847,89333,0.12142209485856291,0.015649312124298972,0.10577278273426394,1.1420669309486493
1474,95631,2041,6651,884,1033,1917,8568,0.22373949579831934,0.12056489262371616,0.10317460317460317,1.0646844027125717
1475,95632,4444,30925,3447,578,4025,34950,0.11516452074391989,0.0165379113018598,0.09862660944206009,1.1040993788819875
1476,95633,845,3430,362,366,728,4158,0.1750841750841751,0.08802308802308802,0.08706108706108706,1.1607142857142858
1477,95634,789,3502,379,344,723,4225,0.1711242603550296,0.08142011834319526,0.08970414201183433,1.0912863070539418
1478,95635,282,1176,120,135,255,1431,0.17819706498951782,0.09433962264150944,0.08385744234800839,1.1058823529411765
1479,95636,353,1752,288,115,403,2155,0.18700696055684454,0.05336426914153132,0.13364269141531324,0.8759305210918115
1480,95637,62,299,40,11,51,350,0.1457142857142857,0.03142857142857143,0.11428571428571428,1.2156862745098038
1481,95638,430,2224,220,63,283,2507,0.11288392500997207,0.02512963701635421,0.08775428799361787,1.519434628975265
1482,95639,36,241,26,10,36,277,0.1299638989169675,0.036101083032490974,0.09386281588447654,1.0
1483,95640,2165,10591,1317,435,1752,12343,0.1419428015879446,0.035242647654541034,0.10670015393340355,1.235730593607306
1484,95641,323,2116,248,60,308,2424,0.12706270627062707,0.024752475247524754,0.10231023102310231,1.0487012987012987
1485,95642,1696,8941,1034,473,1507,10448,0.14423813169984687,0.04527182235834609,0.09896630934150076,1.1254147312541474
1486,95645,158,1152,118,31,149,1301,0.11452728670253651,0.02382782475019216,0.09069946195234435,1.0604026845637584
1487,95646,117,767,66,36,102,869,0.11737629459148446,0.04142692750287687,0.0759493670886076,1.1470588235294117
1488,95648,11197,71062,9019,1068,10087,81149,0.1243022095158289,0.013160975489531603,0.1111412340262973,1.1100426291265986
1489,95650,2626,16094,1787,669,2456,18550,0.1323989218328841,0.03606469002695418,0.09633423180592991,1.0692182410423452
1490,95651,146,874,75,71,146,1020,0.14313725490196078,0.0696078431372549,0.07352941176470588,1.0
1491,95653,43,433,36,10,46,479,0.09603340292275574,0.020876826722338204,0.07515657620041753,0.9347826086956522
1492,95655,761,4754,597,112,709,5463,0.12978217096833242,0.020501555921654768,0.10928061504667765,1.073342736248237
1493,95656,46,447,38,24,62,509,0.12180746561886051,0.047151277013752456,0.07465618860510806,0.7419354838709677
1494,95658,1478,8127,810,526,1336,9463,0.14118144351685513,0.055584909648103135,0.08559653386875198,1.1062874251497006
1495,95659,72,504,42,15,57,561,0.10160427807486631,0.026737967914438502,0.0748663101604278,1.263157894736842
1496,95660,4469,27288,3463,856,4319,31607,0.1366469452969279,0.02708260828297529,0.1095643370139526,1.0347302616346377
1497,95661,4533,34073,3899,476,4375,38448,0.11379005409904286,0.012380357885975864,0.101409696213067,1.0361142857142858
1498,95662,5149,38502,4291,763,5054,43556,0.11603453025989531,0.017517678391036826,0.09851685186885849,1.018796992481203
1499,95663,602,3317,413,194,607,3924,0.15468909276248727,0.04943934760448522,0.10524974515800203,0.9917627677100495
1500,95664,327,1388,141,172,313,1701,0.18400940623162845,0.1011169900058789,0.08289241622574955,1.0447284345047922
1501,95665,1422,5241,660,577,1237,6478,0.1909539981475764,0.08907070083359062,0.1018832973139858,1.1495553759094583
1502,95666,2317,9178,1141,1090,2231,11409,0.19554737487948112,0.09553860986940135,0.10000876501007976,1.0385477364410578
1503,95667,9043,39475,4733,3693,8426,47901,0.17590446963528944,0.07709651155508236,0.09880795808020709,1.0732257298836934
1504,95668,53,552,50,14,64,616,0.1038961038961039,0.022727272727272728,0.08116883116883117,0.828125
1505,95669,573,2668,287,152,439,3107,0.14129385259092372,0.04892178950756357,0.09237206308336016,1.3052391799544418
1506,95670,7552,51252,6275,958,7233,58485,0.12367273659912797,0.0163802684449004,0.10729246815422758,1.0441034149039126
1507,95672,1034,5342,600,392,992,6334,0.15661509314808966,0.06188822229239027,0.0947268708556994,1.0423387096774193
1508,95673,2555,16242,2000,546,2546,18788,0.1355120289546519,0.029061102831594635,0.10645092612305727,1.0035349567949725
1509,95674,73,559,46,21,67,626,0.10702875399361023,0.03354632587859425,0.07348242811501597,1.0895522388059702
1510,95675,94,339,33,45,78,417,0.18705035971223022,0.1079136690647482,0.07913669064748201,1.205128205128205
1511,95676,28,254,23,3,26,280,0.09285714285714286,0.010714285714285714,0.08214285714285714,1.0769230769230769
1512,95677,4614,28658,3423,558,3981,32639,0.12197064861055792,0.0170961120132357,0.10487453659732222,1.1590052750565185
1513,95678,6134,43497,5301,812,6113,49610,0.1232211247732312,0.016367667808909494,0.1068534569643217,1.0034353018158024
1514,95679,12,55,5,4,9,64,0.140625,0.0625,0.078125,1.3333333333333333
1515,95680,4,36,4,1,5,41,0.12195121951219512,0.024390243902439025,0.0975609756097561,0.8
1516,95681,197,1418,145,54,199,1617,0.12306740878169449,0.03339517625231911,0.08967223252937538,0.9899497487437185
1517,95682,5451,31747,3670,1590,5260,37007,0.14213527170535303,0.04296484448888048,0.09917042721647255,1.0363117870722434
1518,95683,1452,9268,1177,188,1365,10633,0.1283739302172482,0.017680805040910373,0.11069312517633782,1.0637362637362637
1519,95684,747,3794,370,345,715,4509,0.1585717453980927,0.07651363938789088,0.08205810601020182,1.0447552447552448
1520,95685,1218,6013,678,422,1100,7113,0.15464642204414453,0.05932799100238999,0.09531843104175454,1.1072727272727272
1521,95686,119,697,106,27,133,830,0.1602409638554217,0.03253012048192771,0.12771084337349398,0.8947368421052632
1522,95687,8661,64883,6976,802,7778,72661,0.10704504479707133,0.011037557974704449,0.09600748682236689,1.1135253278477757
1523,95688,5241,42318,4342,576,4918,47236,0.1041155051232111,0.012194089253958845,0.09192141586925226,1.06567710451403
1524,95689,483,2083,230,204,434,2517,0.1724274930472785,0.08104886769964244,0.09137862534763608,1.1129032258064515
1525,95690,217,1700,186,48,234,1934,0.12099276111685625,0.02481902792140641,0.09617373319544985,0.9273504273504274
1526,95691,5680,38029,4300,715,5015,43044,0.1165086887835703,0.016610909766750302,0.09989777901682,1.1326021934197408
1527,95692,798,4896,585,125,710,5606,0.12665001783803068,0.022297538351765966,0.10435247948626472,1.123943661971831
1528,95693,1109,8175,833,194,1027,9202,0.11160617257118018,0.02108237339708759,0.09052379917409259,1.0798442064264848
1529,95694,1244,8555,773,197,970,9525,0.10183727034120735,0.02068241469816273,0.08115485564304462,1.2824742268041238
1530,95695,3635,34346,3021,626,3647,37993,0.09599136683073198,0.01647671939567815,0.07951464743505382,0.9967096243487799
1531,95697,32,249,18,8,26,275,0.09454545454545454,0.02909090909090909,0.06545454545454546,1.2307692307692308
1532,95698,23,198,16,6,22,220,0.1,0.02727272727272727,0.07272727272727272,1.0454545454545454
1533,95699,35,112,10,11,21,133,0.15789473684210525,0.08270676691729323,0.07518796992481203,1.6666666666666667
1534,95701,272,1220,128,126,254,1474,0.1723202170963365,0.08548168249660787,0.08683853459972862,1.0708661417322836
1535,95703,549,2093,273,277,550,2643,0.20809685962920924,0.10480514566780175,0.10329171396140749,0.9981818181818182
1536,95709,1398,5464,701,623,1324,6788,0.19505008839127871,0.0917796110783736,0.10327047731290513,1.055891238670695
1537,95712,1,11,4,1,5,16,0.3125,0.0625,0.25,0.2
1538,95713,2471,9690,1208,1163,2371,12061,0.19658403117486112,0.09642649863195424,0.1001575325429069,1.0421762969211303
1539,95714,124,610,59,58,117,727,0.1609353507565337,0.07977991746905089,0.0811554332874828,1.0598290598290598
1540,95715,81,285,57,21,78,363,0.21487603305785125,0.05785123966942149,0.15702479338842976,1.0384615384615385
1541,95717,57,245,31,15,46,291,0.15807560137457044,0.05154639175257732,0.10652920962199312,1.2391304347826086
1542,95720,156,1023,101,88,189,1212,0.15594059405940594,0.07260726072607261,0.08333333333333333,0.8253968253968254
1543,95721,53,410,35,30,65,475,0.1368421052631579,0.06315789473684211,0.07368421052631578,0.8153846153846154
1544,95722,1663,5625,698,833,1531,7156,0.21394633873672442,0.11640581330352152,0.09754052543320291,1.086218158066623
1545,95724,63,616,50,34,84,700,0.12,0.04857142857142857,0.07142857142857142,0.75
1546,95726,3217,10852,1597,1479,3076,13928,0.2208500861573808,0.1061889718552556,0.11466111430212522,1.0458387516254877
1547,95728,534,3477,356,152,508,3985,0.1274780426599749,0.03814303638644918,0.08933500627352572,1.0511811023622046
1548,95735,179,1210,109,84,193,1403,0.1375623663578047,0.05987170349251604,0.07769066286528867,0.927461139896373
1549,95736,61,669,48,47,95,764,0.1243455497382199,0.061518324607329845,0.06282722513089005,0.6421052631578947
1550,95742,3874,15887,2445,258,2703,18590,0.14540075309306078,0.013878429263044648,0.13152232383001614,1.4332223455419904
1551,95746,4447,27780,3319,1005,4324,32104,0.1346872663842512,0.03130451034139048,0.10338275604286071,1.0284458834412582
1552,95747,16679,87548,11785,1225,13010,100558,0.1293780703673502,0.01218202430438155,0.11719604606296863,1.2820138355111452
1553,95757,8811,50298,6846,621,7467,57765,0.12926512594131395,0.010750454427421448,0.1185146715138925,1.1799919646444355
1554,95758,9230,67494,7808,1015,8823,76317,0.1156098903258776,0.013299789037829055,0.10231010128804853,1.0461294344327325
1555,95762,11075,55220,7647,2043,9690,64910,0.14928362347866275,0.031474349098752116,0.11780927437991065,1.1429308565531475
1556,95765,7273,40723,5703,554,6257,46980,0.1331843337590464,0.01179225202213708,0.12139208173690932,1.1623781364871344
1557,95776,3953,22594,2538,344,2882,25476,0.11312607944732297,0.013502904694614539,0.09962317475270843,1.371616932685635
1558,95811,546,2828,368,74,442,3270,0.13516819571865443,0.022629969418960245,0.11253822629969419,1.2352941176470589
1559,95814,355,2141,291,66,357,2498,0.14291433146517213,0.02642113690952762,0.11649319455564451,0.9943977591036415
1560,95815,3650,18203,2632,811,3443,21646,0.15905941051464473,0.037466506513905574,0.12159290400073916,1.0601219866395586
1561,95816,2153,15035,1578,279,1857,16892,0.10993369642434288,0.016516694293156525,0.09341700213118637,1.1593968766828218
1562,95817,2426,15442,1872,395,2267,17709,0.1280140041786662,0.022305042633689084,0.10570896154497714,1.070136744596383
1563,95818,3114,25378,2495,412,2907,28285,0.1027753226091568,0.014566024394555418,0.08820929821460138,1.0712074303405572
1564,95819,2954,25861,2411,389,2800,28661,0.09769373015596106,0.013572450368096019,0.08412127978786504,1.055
1565,95820,6230,38757,4687,1152,5839,44596,0.13093102520405417,0.0258319131760696,0.10509911202798457,1.066963521150882
1566,95821,4019,29354,3421,557,3978,33332,0.11934477379095164,0.01671066842673707,0.10263410536421456,1.010306686777275
1567,95822,6420,47714,5061,1175,6236,53950,0.1155885078776645,0.021779425393883226,0.09380908248378128,1.0295060936497755
1568,95823,8594,54848,6722,1459,8181,63029,0.1297973948499897,0.02314807469577496,0.10664932015421473,1.0504828260603838
1569,95824,3791,21610,2754,811,3565,25175,0.14160873882820257,0.032214498510427014,0.10939424031777557,1.0633941093969144
1570,95825,1796,11049,1490,272,1762,12811,0.13753805323550075,0.02123175396143939,0.11630629927406136,1.0192962542565267
1571,95826,4543,36425,3851,640,4491,40916,0.1097614625085541,0.015641802717763224,0.09411965979079089,1.0115787129815186
1572,95827,2798,19460,2250,441,2691,22151,0.12148435736535597,0.01990880772877071,0.10157554963658526,1.0397621701969528
1573,95828,9149,55073,6978,1505,8483,63556,0.1334728428472528,0.023679904336333314,0.10979293851091951,1.078509961098668
1574,95829,5473,31754,4055,638,4693,36447,0.12876231239882568,0.01750487008532938,0.11125744231349631,1.1662049861495845
1575,95830,126,928,111,22,133,1061,0.12535344015080113,0.020735155513666354,0.10461828463713478,0.9473684210526315
1576,95831,4582,47406,3863,590,4453,51859,0.08586744827320233,0.011377003027439788,0.07449044524576255,1.0289692342241186
1577,95832,1526,9170,1144,252,1396,10566,0.1321219004353587,0.02385008517887564,0.10827181525648306,1.0931232091690544
1578,95833,4763,30849,3819,638,4457,35306,0.12623916614739705,0.018070582903755735,0.10816858324364131,1.0686560466681625
1579,95834,6816,24832,3953,540,4493,29325,0.15321398124467178,0.018414322250639385,0.1347996589940324,1.5170264856443356
1580,95835,7251,39857,5811,636,6447,46304,0.13923203178991017,0.013735314443676571,0.12549671734623358,1.124709167054444
1581,95837,54,369,38,15,53,422,0.12559241706161137,0.035545023696682464,0.09004739336492891,1.0188679245283019
1582,95838,5848,31168,4116,1159,5275,36443,0.14474659056608952,0.03180308975660621,0.1129435008094833,1.1086255924170616
1583,95841,2306,13510,1832,397,2229,15739,0.14162272063028147,0.025223965944469153,0.11639875468581232,1.034544638851503
1584,95842,4184,26429,3380,673,4053,30482,0.1329637162915819,0.022078603766157077,0.11088511252542484,1.0323217369849493
1585,95843,6905,42386,5687,860,6547,48933,0.13379518934052684,0.017575051601168946,0.1162201377393579,1.0546815335268063
1586,95864,4089,32016,3314,641,3955,35971,0.10994968168802646,0.017819910483444997,0.09212977120458146,1.033881163084703
1587,95901,5282,29138,3834,881,4715,33853,0.13927864591025907,0.026024281452160812,0.11325436445809825,1.120254506892895
1588,95910,10,97,16,13,29,126,0.23015873015873015,0.10317460317460317,0.12698412698412698,0.3448275862068966
1589,95912,536,3779,421,101,522,4301,0.12136712392466868,0.02348291095094164,0.09788421297372704,1.0268199233716475
1590,95913,38,251,36,13,49,300,0.16333333333333333,0.043333333333333335,0.12,0.7755102040816326
1591,95914,158,806,123,57,180,986,0.18255578093306288,0.057809330628803245,0.12474645030425964,0.8777777777777778
1592,95916,240,1660,338,142,480,2140,0.22429906542056074,0.06635514018691589,0.15794392523364487,0.5
1593,95917,470,3151,321,102,423,3574,0.11835478455512032,0.028539451594851706,0.08981533296026861,1.1111111111111112
1594,95918,514,2639,310,170,480,3119,0.15389547932029496,0.0545046489259378,0.09939083039435717,1.0708333333333333
1595,95919,262,1112,159,166,325,1437,0.22616562282533054,0.11551844119693806,0.11064718162839249,0.8061538461538461
1596,95920,20,115,15,9,24,139,0.17266187050359713,0.06474820143884892,0.1079136690647482,0.8333333333333334
1597,95922,75,567,60,43,103,670,0.1537313432835821,0.06417910447761194,0.08955223880597014,0.7281553398058253
1598,95923,43,470,38,22,60,530,0.11320754716981132,0.04150943396226415,0.07169811320754717,0.7166666666666667
1599,95924,8,68,6,5,11,79,0.13924050632911392,0.06329113924050633,0.0759493670886076,0.7272727272727273
1600,95925,46,263,25,29,54,317,0.17034700315457413,0.0914826498422713,0.07886435331230283,0.8518518518518519
1601,95926,4237,34033,3569,538,4107,38140,0.10768222338751966,0.014105925537493446,0.09357629785002622,1.0316532748965181
1602,95928,4576,33099,3742,681,4423,37522,0.11787751185970897,0.018149352379937103,0.09972815947977187,1.0345919059461903
1603,95929,0,26,3,0,3,29,0.10344827586206896,0.0,0.10344827586206896,0.0
1604,95930,99,409,55,41,96,505,0.1900990099009901,0.08118811881188119,0.10891089108910891,1.03125
1605,95932,911,6842,675,207,882,7724,0.11418953909891248,0.026799585706887622,0.08738995339202486,1.0328798185941044
1606,95934,30,325,19,13,32,357,0.0896358543417367,0.036414565826330535,0.05322128851540616,0.9375
1607,95935,158,781,108,85,193,974,0.19815195071868583,0.08726899383983573,0.11088295687885011,0.8186528497409327
1608,95936,90,536,49,47,96,632,0.1518987341772152,0.07436708860759493,0.07753164556962025,0.9375
1609,95937,175,1079,114,41,155,1234,0.12560777957860617,0.03322528363047002,0.09238249594813615,1.1290322580645162
1610,95938,454,3816,381,74,455,4271,0.10653242800280964,0.01732615312573168,0.08920627487707797,0.9978021978021978
1611,95939,37,285,27,12,39,324,0.12037037037037036,0.037037037037037035,0.08333333333333333,0.9487179487179487
1612,95941,83,445,58,69,127,572,0.22202797202797203,0.12062937062937062,0.10139860139860139,0.6535433070866141
1613,95942,464,2235,233,222,455,2690,0.1691449814126394,0.08252788104089219,0.08661710037174722,1.0197802197802197
1614,95943,11,148,17,3,20,168,0.11904761904761904,0.017857142857142856,0.10119047619047619,0.55
1615,95944,8,53,3,4,7,60,0.11666666666666667,0.06666666666666667,0.05,1.1428571428571428
1616,95945,5487,27353,3286,2302,5588,32941,0.1696366230533378,0.06988251722777086,0.09975410582556692,0.9819255547602004
1617,95946,3174,14585,2083,1035,3118,17703,0.17612833982940745,0.058464667005592275,0.11766367282381517,1.0179602309172546
1618,95947,342,2194,288,105,393,2587,0.1519134132199459,0.040587553150367224,0.11132586006957866,0.8702290076335878
1619,95948,1405,9751,1099,267,1366,11117,0.12287487631555276,0.02401727084645138,0.09885760546910137,1.028550512445095
1620,95949,6753,23041,3438,3368,6806,29847,0.2280296177170235,0.11284216169129226,0.11518745602573123,0.9922127534528358
1621,95950,20,217,13,9,22,239,0.09205020920502092,0.03765690376569038,0.05439330543933055,0.9090909090909091
1622,95951,216,1986,173,38,211,2197,0.09604005461993628,0.01729631315430132,0.07874374146563495,1.0236966824644549
1623,95953,1430,8856,991,212,1203,10059,0.11959439308082315,0.02107565364350333,0.09851873943731981,1.1886949293433084
1624,95954,2078,13238,2613,1021,3634,16872,0.2153864390706496,0.060514461830251304,0.1548719772403983,0.5718216840946615
1625,95955,115,818,54,38,92,910,0.1010989010989011,0.041758241758241756,0.05934065934065934,1.25
1626,95956,118,809,67,46,113,922,0.12255965292841649,0.049891540130151846,0.07266811279826464,1.0442477876106195
1627,95957,81,423,38,29,67,490,0.13673469387755102,0.05918367346938776,0.07755102040816327,1.208955223880597
1628,95958,11,56,6,3,9,65,0.13846153846153847,0.046153846153846156,0.09230769230769231,1.2222222222222223
1629,95959,4421,22882,2480,1809,4289,27171,0.15785212174745133,0.0665783371977476,0.09127378454970372,1.0307764047563535
1630,95960,112,589,56,70,126,715,0.17622377622377622,0.0979020979020979,0.07832167832167833,0.8888888888888888
1631,95961,5732,25920,3894,693,4587,30507,0.15035893401514405,0.022716097944733997,0.12764283607041008,1.249618487028559
1632,95962,259,1419,142,87,229,1648,0.13895631067961164,0.05279126213592233,0.08616504854368932,1.1310043668122272
1633,95963,1738,13398,1304,314,1618,15016,0.1077517314864145,0.020911028236547682,0.08684070324986681,1.0741656365883807
1634,95965,2457,16050,1839,609,2448,18498,0.13233863120337333,0.032922478105741164,0.09941615309763217,1.0036764705882353
1635,95966,6247,32003,4231,2308,6539,38542,0.16965907321882623,0.059882725338591666,0.10977634788023455,0.9553448539532039
1636,95968,177,1505,134,55,189,1694,0.1115702479338843,0.032467532467532464,0.07910271546635184,0.9365079365079365
1637,95969,2877,24350,7014,1344,8358,32708,0.2555338143573438,0.041090864620276384,0.21444294973706737,0.3442211055276382
1638,95970,38,421,39,13,52,473,0.10993657505285412,0.02748414376321353,0.0824524312896406,0.7307692307692307
1639,95971,1076,7870,743,279,1022,8892,0.11493477282950967,0.03137651821862348,0.08355825461088619,1.0528375733855186
1640,95972,29,201,21,17,38,239,0.1589958158995816,0.07112970711297072,0.08786610878661087,0.7631578947368421
1641,95973,5891,37161,4328,718,5046,42207,0.11955362854502807,0.017011396213898168,0.10254223233112991,1.1674593737613952
1642,95974,43,267,33,13,46,313,0.14696485623003194,0.04153354632587859,0.10543130990415335,0.9347826086956522
1643,95975,383,1848,190,179,369,2217,0.16644113667117727,0.08073973838520523,0.08570139828597204,1.037940379403794
1644,95977,381,1781,233,184,417,2198,0.1897179253867152,0.08371246587807098,0.10600545950864422,0.9136690647482014
1645,95978,46,311,30,59,89,400,0.2225,0.1475,0.075,0.5168539325842697
1646,95979,110,902,78,21,99,1001,0.0989010989010989,0.02097902097902098,0.07792207792207792,1.1111111111111112
1647,95981,117,668,57,60,117,785,0.14904458598726114,0.07643312101910828,0.07261146496815286,1.0
1648,95982,572,3823,440,98,538,4361,0.12336620041274937,0.02247191011235955,0.10089429030038982,1.063197026022305
1649,95983,102,695,80,27,107,802,0.13341645885286782,0.03366583541147132,0.09975062344139651,0.9532710280373832
1650,95984,17,107,13,6,19,126,0.15079365079365079,0.047619047619047616,0.10317460317460317,0.8947368421052632
1651,95986,21,152,11,17,28,180,0.15555555555555556,0.09444444444444444,0.06111111111111111,0.75
1652,95987,616,4562,421,105,526,5088,0.10338050314465409,0.020636792452830188,0.0827437106918239,1.1711026615969582
1653,95988,980,7636,694,209,903,8539,0.10575008783229886,0.024475933950111255,0.08127415388218762,1.0852713178294573
1654,95991,5217,34156,4200,817,5017,39173,0.12807290735966098,0.020856201975850714,0.10721670538381027,1.0398644608331673
1655,95993,5280,36237,4448,675,5123,41360,0.12386363636363637,0.016320116054158607,0.10754352030947775,1.0306461057973844
1656,96001,6290,40946,5084,1248,6332,47278,0.1339312153644401,0.026397055713016624,0.10753415965142349,0.9933670246367656
1657,96002,5628,35385,4506,935,5441,40826,0.13327291431930632,0.022902072208886494,0.11037084211041984,1.0343686822275318
1658,96003,8086,47999,6198,1574,7772,55771,0.1393555790643883,0.028222552939699844,0.11113302612468846,1.0404014410705096
1659,96006,75,617,59,15,74,691,0.10709117221418235,0.02170767004341534,0.085383502170767,1.0135135135135136
1660,96007,3945,25269,2831,971,3802,29071,0.13078325478999692,0.03340098379828695,0.09738227099170996,1.037611783271962
1661,96008,280,1518,185,106,291,1809,0.16086235489220563,0.058595909342177996,0.10226644555002765,0.9621993127147767
1662,96009,54,411,36,14,50,461,0.10845986984815618,0.03036876355748373,0.07809110629067245,1.08
1663,96010,8,154,11,6,17,171,0.09941520467836257,0.03508771929824561,0.06432748538011696,0.47058823529411764
1664,96011,8,57,6,6,12,69,0.17391304347826086,0.08695652173913043,0.08695652173913043,0.6666666666666666
1665,96013,902,5006,556,305,861,5867,0.1467530253962843,0.05198568263166865,0.09476734276461565,1.0476190476190477
1666,96014,24,228,15,13,28,256,0.109375,0.05078125,0.05859375,0.8571428571428571
1667,96015,32,204,22,7,29,233,0.12446351931330472,0.030042918454935622,0.0944206008583691,1.103448275862069
1668,96016,103,711,64,34,98,809,0.1211372064276885,0.042027194066749075,0.07911001236093942,1.0510204081632653
1669,96017,49,375,33,22,55,430,0.12790697674418605,0.05116279069767442,0.07674418604651163,0.8909090909090909
1670,96019,2236,12395,1514,555,2069,14464,0.14304480088495575,0.03837112831858407,0.10467367256637168,1.0807153214113099
1671,96020,800,5100,552,208,760,5860,0.1296928327645051,0.03549488054607509,0.09419795221843004,1.0526315789473684
1672,96021,2337,13403,1585,594,2179,15582,0.13984084199717622,0.03812090874085483,0.1017199332563214,1.0725103258375401
1673,96022,3332,18963,2251,887,3138,22101,0.1419845255870775,0.04013393059137595,0.10185059499570155,1.0618228170809432
1674,96023,190,1150,141,64,205,1355,0.15129151291512916,0.047232472324723246,0.10405904059040591,0.926829268292683
1675,96024,104,1277,105,47,152,1429,0.10636808957312806,0.032890132960111965,0.0734779566130161,0.6842105263157895
1676,96025,580,3481,384,244,628,4109,0.15283523971769286,0.05938184473107812,0.09345339498661474,0.9235668789808917
1677,96027,311,2594,235,76,311,2905,0.10705679862306368,0.026161790017211705,0.08089500860585198,1.0
1678,96028,317,1871,190,103,293,2164,0.1353974121996303,0.047597042513863215,0.0878003696857671,1.081911262798635
1679,96029,14,81,15,3,18,99,0.18181818181818182,0.030303030303030304,0.15151515151515152,0.7777777777777778
1680,96031,0,30,12,2,14,44,0.3181818181818182,0.045454545454545456,0.2727272727272727,0.0
1681,96032,378,2642,254,100,354,2996,0.11815754339118825,0.03337783711615487,0.08477970627503338,1.0677966101694916
1682,96033,53,481,56,15,71,552,0.1286231884057971,0.02717391304347826,0.10144927536231885,0.7464788732394366
1683,96034,39,249,39,7,46,295,0.15593220338983052,0.023728813559322035,0.13220338983050847,0.8478260869565217
1684,96035,411,2791,300,106,406,3197,0.12699405692837035,0.033156083828589304,0.09383797309978105,1.0123152709359606
1685,96037,65,391,42,7,49,440,0.11136363636363636,0.015909090909090907,0.09545454545454546,1.3265306122448979
1686,96038,59,630,69,15,84,714,0.11764705882352941,0.02100840336134454,0.09663865546218488,0.7023809523809523
1687,96039,60,711,79,40,119,830,0.14337349397590363,0.04819277108433735,0.09518072289156626,0.5042016806722689
1688,96040,44,349,37,14,51,400,0.1275,0.035,0.0925,0.8627450980392157
1689,96041,317,2543,287,110,397,2940,0.13503401360544218,0.03741496598639456,0.09761904761904762,0.7984886649874056
1690,96044,237,1337,170,64,234,1571,0.14894971355824316,0.04073838319541693,0.10821133036282622,1.0128205128205128
1691,96046,14,255,16,7,23,278,0.08273381294964029,0.025179856115107913,0.05755395683453238,0.6086956521739131
1692,96047,134,909,110,46,156,1065,0.14647887323943662,0.0431924882629108,0.10328638497652583,0.8589743589743589
1693,96048,75,829,79,24,103,932,0.11051502145922747,0.02575107296137339,0.08476394849785408,0.7281553398058253
1694,96049,0,33,4,2,6,39,0.15384615384615385,0.05128205128205128,0.10256410256410256,0.0
1695,96050,45,436,27,25,52,488,0.10655737704918032,0.05122950819672131,0.055327868852459015,0.8653846153846154
1696,96051,284,2111,243,97,340,2451,0.138718890248878,0.039575683394532844,0.09914320685434516,0.8352941176470589
1697,96052,199,2089,158,67,225,2314,0.0972342264477096,0.02895419187554019,0.0682800345721694,0.8844444444444445
1698,96054,27,223,22,8,30,253,0.11857707509881422,0.03162055335968379,0.08695652173913043,0.9
1699,96055,660,3804,495,165,660,4464,0.1478494623655914,0.03696236559139785,0.11088709677419355,1.0
1700,96056,220,1684,162,60,222,1906,0.11647429171038824,0.03147953830010493,0.08499475341028331,0.990990990990991
1701,96057,576,2708,314,191,505,3213,0.15717398070339247,0.05944600062247121,0.09772798008092126,1.1405940594059405
1702,96058,48,414,27,19,46,460,0.1,0.041304347826086954,0.058695652173913045,1.0434782608695652
1703,96059,133,672,83,48,131,803,0.16313823163138233,0.05977584059775841,0.10336239103362391,1.015267175572519
1704,96061,100,557,55,33,88,645,0.13643410852713178,0.05116279069767442,0.08527131782945736,1.1363636363636365
1705,96062,198,1347,130,51,181,1528,0.11845549738219895,0.03337696335078534,0.08507853403141362,1.0939226519337018
1706,96063,57,468,33,40,73,541,0.13493530499075784,0.07393715341959335,0.06099815157116451,0.7808219178082192
1707,96064,809,5180,554,187,741,5921,0.1251477790913697,0.03158250295558183,0.09356527613578787,1.0917678812415654
1708,96065,83,623,61,32,93,716,0.12988826815642457,0.0446927374301676,0.08519553072625698,0.8924731182795699
1709,96067,1469,11387,1060,386,1446,12833,0.11267825138315281,0.030078703342943974,0.08259954804020883,1.015905947441217
1710,96068,3,33,10,6,16,49,0.32653061224489793,0.12244897959183673,0.20408163265306123,0.1875
1711,96069,166,1102,108,79,187,1289,0.14507370054305663,0.0612878200155159,0.08378588052754073,0.8877005347593583
1712,96071,72,580,53,26,79,659,0.11987860394537178,0.03945371775417299,0.08042488619119878,0.9113924050632911
1713,96073,967,5744,632,246,878,6622,0.13258834189066748,0.037148897614013895,0.09543944427665357,1.101366742596811
1714,96074,12,112,9,5,14,126,0.1111111111111111,0.03968253968253968,0.07142857142857142,0.8571428571428571
1715,96075,33,307,32,12,44,351,0.12535612535612536,0.03418803418803419,0.09116809116809117,0.75
1716,96076,20,160,22,14,36,196,0.1836734693877551,0.07142857142857142,0.11224489795918367,0.5555555555555556
1717,96078,15,96,10,5,15,111,0.13513513513513514,0.04504504504504504,0.09009009009009009,1.0
1718,96080,4627,31276,3576,958,4534,35810,0.12661267802289863,0.026752303825746997,0.09986037419715163,1.0205116894574326
1719,96084,63,509,51,22,73,582,0.1254295532646048,0.037800687285223365,0.08762886597938144,0.863013698630137
1720,96085,13,90,8,8,16,106,0.1509433962264151,0.07547169811320754,0.07547169811320754,0.8125
1721,96086,35,338,24,12,36,374,0.0962566844919786,0.03208556149732621,0.06417112299465241,0.9722222222222222
1722,96087,118,943,154,62,216,1159,0.18636755823986195,0.05349439171699741,0.13287316652286454,0.5462962962962963
1723,96088,1237,7375,833,407,1240,8615,0.14393499709808474,0.04724318049912943,0.09669181659895532,0.9975806451612903
1724,96089,26,174,23,14,37,211,0.17535545023696683,0.06635071090047394,0.10900473933649289,0.7027027027027027
1725,96090,63,596,58,14,72,668,0.10778443113772455,0.020958083832335328,0.08682634730538923,0.875
1726,96091,173,1894,138,82,220,2114,0.10406811731315042,0.03878902554399243,0.065279091769158,0.7863636363636364
1727,96092,36,246,16,12,28,274,0.10218978102189781,0.043795620437956206,0.058394160583941604,1.2857142857142858
1728,96093,559,5144,401,149,550,5694,0.0965929048120829,0.02616789603090973,0.07042500878117317,1.0163636363636364
1729,96094,1374,9550,1018,311,1329,10879,0.12216196341575512,0.02858718632227227,0.09357477709348286,1.0338600451467268
1730,96096,145,895,85,59,144,1039,0.13859480269489893,0.05678537054860443,0.08180943214629452,1.0069444444444444
1731,96097,1524,11160,1094,365,1459,12619,0.11561930422378952,0.028924637451462083,0.08669466677232744,1.0445510623714873
1732,96101,985,6403,737,206,943,7346,0.12836918050639803,0.02804247209365641,0.10032670841274163,1.0445387062566278
1733,96103,673,4761,478,162,640,5401,0.11849657470838734,0.029994445473060544,0.08850212923532678,1.0515625
1734,96104,119,801,83,20,103,904,0.11393805309734513,0.022123893805309734,0.0918141592920354,1.1553398058252426
1735,96105,71,675,55,27,82,757,0.1083223249669749,0.035667107001321,0.0726552179656539,0.8658536585365854
1736,96106,153,1075,119,35,154,1229,0.12530512611879577,0.028478437754271765,0.096826688364524,0.9935064935064936
1737,96107,165,1059,128,50,178,1237,0.1438965238480194,0.04042037186742118,0.10347615198059822,0.9269662921348315
1738,96108,33,227,24,3,27,254,0.1062992125984252,0.011811023622047244,0.09448818897637795,1.2222222222222223
1739,96109,126,894,94,52,146,1040,0.14038461538461539,0.05,0.09038461538461538,0.863013698630137
1740,96110,14,129,24,5,29,158,0.18354430379746836,0.03164556962025317,0.1518987341772152,0.4827586206896552
1741,96111,44,205,20,12,32,237,0.1350210970464135,0.05063291139240506,0.08438818565400844,1.375
1742,96112,22,156,14,7,21,177,0.11864406779661017,0.03954802259887006,0.07909604519774012,1.0476190476190477
1743,96113,124,736,84,35,119,855,0.1391812865497076,0.04093567251461988,0.09824561403508772,1.0420168067226891
1744,96114,525,3844,391,129,520,4364,0.11915673693858846,0.029560036663611365,0.08959670027497708,1.0096153846153846
1745,96115,29,137,16,8,24,161,0.14906832298136646,0.049689440993788817,0.09937888198757763,1.2083333333333333
1746,96116,8,189,8,2,10,199,0.05025125628140704,0.010050251256281407,0.04020100502512563,0.8
1747,96117,42,306,31,12,43,349,0.12320916905444126,0.034383954154727794,0.08882521489971347,0.9767441860465116
1748,96118,285,1991,204,90,294,2285,0.12866520787746172,0.03938730853391685,0.08927789934354485,0.9693877551020408
1749,96119,2,48,0,1,1,49,0.02040816326530612,0.02040816326530612,0.0,2.0
1750,96120,260,1444,182,80,262,1706,0.15357561547479484,0.04689331770222743,0.10668229777256741,0.9923664122137404
1751,96121,65,487,57,11,68,555,0.12252252252252252,0.01981981981981982,0.10270270270270271,0.9558823529411765
1752,96122,892,5594,572,267,839,6433,0.1304212653505363,0.041504741178299394,0.0889165241722369,1.063170441001192
1753,96123,1,10,1,0,1,11,0.09090909090909091,0.0,0.09090909090909091,1.0
1754,96124,113,635,58,44,102,737,0.1383989145183175,0.05970149253731343,0.07869742198100407,1.107843137254902
1755,96125,140,1065,77,58,135,1200,0.1125,0.04833333333333333,0.06416666666666666,1.037037037037037
1756,96126,73,412,44,17,61,473,0.12896405919661733,0.035940803382663845,0.09302325581395349,1.1967213114754098
1757,96128,59,498,44,14,58,556,0.10431654676258993,0.025179856115107913,0.07913669064748201,1.0172413793103448
1758,96129,33,317,17,8,25,342,0.07309941520467836,0.023391812865497075,0.049707602339181284,1.32
1759,96130,2623,18571,2077,526,2603,21174,0.12293378671956173,0.024841787097383584,0.09809199962217814,1.0076834421820975
1760,96133,43,229,32,7,39,268,0.1455223880597015,0.026119402985074626,0.11940298507462686,1.1025641025641026
1761,96134,213,1551,182,63,245,1796,0.1364142538975501,0.03507795100222717,0.10133630289532294,0.8693877551020408
1762,96135,2,49,1,0,1,50,0.02,0.0,0.02,2.0
1763,96136,3,24,8,0,8,32,0.25,0.0,0.25,0.375
1764,96137,1750,10475,1211,579,1790,12265,0.14594374235629842,0.047207501019160214,0.0987362413371382,0.9776536312849162
1765,96140,878,4522,503,254,757,5279,0.14339837090358024,0.04811517332828187,0.09528319757529835,1.1598414795244385
1766,96141,546,3226,298,144,442,3668,0.12050163576881134,0.03925845147219193,0.0812431842966194,1.2352941176470589
1767,96142,931,5337,542,246,788,6125,0.1286530612244898,0.04016326530612245,0.08848979591836735,1.1814720812182742
1768,96143,768,4378,475,315,790,5168,0.15286377708978327,0.06095201238390093,0.09191176470588236,0.9721518987341772
1769,96145,1555,8787,917,692,1609,10396,0.15477106579453637,0.06656406310119277,0.0882070026933436,0.966438781852082
1770,96146,623,3749,364,457,821,4570,0.17964989059080963,0.1,0.07964989059080962,0.758830694275274
1771,96148,476,2226,260,134,394,2620,0.150381679389313,0.05114503816793893,0.09923664122137404,1.2081218274111676
1772,96150,9270,53109,6123,3619,9742,62851,0.15500151151135225,0.057580627197657955,0.09742088431369429,0.9515499897351674
1773,96151,16,276,22,10,32,308,0.1038961038961039,0.032467532467532464,0.07142857142857142,0.5
1774,96155,6,126,7,8,15,141,0.10638297872340426,0.05673758865248227,0.04964539007092199,0.4
1775,96158,7,85,4,5,9,94,0.09574468085106383,0.05319148936170213,0.0425531914893617,0.7777777777777778
1776,96160,7,71,8,5,13,84,0.15476190476190477,0.05952380952380952,0.09523809523809523,0.5384615384615384
1777,96161,8432,42685,5240,3047,8287,50972,0.16257945538727145,0.05977791728792278,0.10280153809934867,1.0174972849040667
1778,96162,9,86,12,10,22,108,0.2037037037037037,0.09259259259259259,0.1111111111111111,0.4090909090909091
